type,mode,amount,currentBalance,transactionTimestamp,valueDate,txnId,narration,reference
DEBIT,CARD,100.0,2180.80,2023-06-27T09:40:19+05:30,2023-06-27,S39488701,PRCR/MS NEHA FILLING STATIO/FARRUKHAB,NA
DEBIT,CARD,170.0,2010.80,2023-06-28T09:51:57+05:30,2023-06-28,S76862822,PRCR/MS NEHA FILLING STATIO/FARRUKHAB,NA
DEBIT,CARD,500.0,1510.80,2023-07-26T10:04:00+05:30,2023-07-26,S31451661,PRCR/MS NEHA FILLING STATIO/FARRUKHAB,NA
CREDIT,OTHERS,15.0,1525.80,2023-08-06T11:10:38+05:30,2023-07-31,S66463256,51888100006461IntPd01-05-2023 to 31-07-2023,NA
DEBIT,ATM,1000.0,525.80,2023-08-07T17:13:13+05:30,2023-08-07,S18475743,ATM/CASH/321917012791/XXXXXXXXXXXX8896,NA
DEBIT,UPI,1.0,524.80,2023-08-22T08:05:06+05:30,2023-08-22,S82724622,UPI/323444770475/080506/UPI/8795417446ybl/Paym,NA
CREDIT,UPI,3000.0,3524.80,2023-08-22T11:49:13+05:30,2023-08-22,S90667553,UPI/323441197152/114914/UPI/8795417446ybl/Paym,NA
CREDIT,UPI,300.0,3824.80,2023-08-22T12:20:04+05:30,2023-08-22,S92051775,UPI/323457106254/122004/UPI/9264998949barodamp,NA
DEBIT,UPI,1200.0,2624.80,2023-08-23T08:17:48+05:30,2023-08-23,S20566812,UPI/323568910825/081748/UPI/8795417446ybl/Paym,NA
CREDIT,UPI,400.0,3024.80,2023-08-23T10:51:21+05:30,2023-08-23,S25232032,UPI/323567840697/105122/UPI/kimoroybl/Payment,NA
CREDIT,UPI,500.0,3524.80,2023-08-24T11:32:18+05:30,2023-08-24,S65206796,UPI/323602109737/113218/UPI/9701028466ibl/Paym,NA
CREDIT,UPI,300.0,3824.80,2023-08-24T12:31:36+05:30,2023-08-24,S67741861,UPI/323618540670/123136/UPI/9580229953axl/Paym,NA
DEBIT,UPI,140.0,3684.80,2023-08-24T13:35:21+05:30,2023-08-24,S70447679,UPI/323606328320/133521/UPI/9258641372ybl/Paym,NA
CREDIT,UPI,400.0,4084.80,2023-08-24T16:52:52+05:30,2023-08-24,S78285774,UPI/323628493930/165253/UPI/7479893801ibl/Paym,NA
CREDIT,UPI,750.0,4834.80,2023-08-24T18:22:22+05:30,2023-08-24,S82498542,UPI/323679308931/182222/UPI/7731035157ibl/Paym,NA
DEBIT,UPI,80.0,4754.80,2023-08-24T21:43:55+05:30,2023-08-24,S92519516,UPI/323600260769/214354/UPI/BHARATPE90725406876,NA
DEBIT,UPI,30.0,4724.80,2023-08-24T21:48:01+05:30,2023-08-24,S92652956,UPI/323633683779/214801/UPI/Q057618043ybl/Paym,NA
DEBIT,UPI,2480.0,2244.80,2023-08-25T10:24:38+05:30,2023-08-25,S1271195,UPI/323779418599/102438/UPI/Q201531625ybl/Paym,NA
DEBIT,UPI,1450.0,794.80,2023-08-25T10:39:35+05:30,2023-08-25,S1851691,UPI/323723435211/103935/UPI/KAYUMTRADERSicici/,NA
DEBIT,UPI,120.0,674.80,2023-08-25T12:03:11+05:30,2023-08-25,S5806723,UPI/323795135335/120311/UPI/BHARATPE9000335745,NA
CREDIT,UPI,480.0,1154.80,2023-08-25T16:03:16+05:30,2023-08-25,S16400570,UPI/360354864566/160316/UPI/mayankbhai73590oki,NA
CREDIT,OTHERS,1.0,1155.80,2023-08-25T16:04:31+05:30,2023-08-25,S16470419,IMPS/P2A/323716492303/PHONEPEPRIVATEL/IMPSAXB9111,NA
DEBIT,UPI,1.0,1154.80,2023-08-25T16:15:02+05:30,2023-08-25,S16919432,UPI/360322594403/161502/UPI/paytm-53692591payt,NA
DEBIT,UPI,1.0,1153.80,2023-08-25T16:19:10+05:30,2023-08-25,S17095662,UPI/323756969282/161910/UPI/arbazahmad161okici,NA
CREDIT,UPI,21.0,1174.80,2023-08-25T16:19:20+05:30,2023-08-25,S17104503,UPI/323784208807/161921/UPI/goog-paymentokaxis,NA
CREDIT,OTHERS,1.0,1175.80,2023-08-25T16:41:37+05:30,2023-08-25,S18054437,NEFT-AXNPN32379238097-PHONEPE PRIVATE LIMITED,920020066838981
DEBIT,UPI,1000.0,175.80,2023-08-25T16:56:59+05:30,2023-08-25,S18720196,UPI/323737522524/165659/UPI/9455566771ibl/Paym,NA
DEBIT,UPI,30.0,145.80,2023-08-25T18:23:59+05:30,2023-08-25,S22642750,UPI/360372011100/182358/UPI/9580229953ybl/Paym,NA
CREDIT,OTHERS,51.0,196.80,2023-08-25T18:37:02+05:30,2023-08-25,S23309045,IMPS/P2A/323718489753/PHONEPEPRIVATEL/IMPSAXB9111,NA
DEBIT,UPI,1.0,195.80,2023-08-26T15:06:16+05:30,2023-08-26,S51405185,UPI/323834868218/150615/UPI/BHARATPE9006655445,NA
CREDIT,UPI,500.0,695.80,2023-08-26T19:25:59+05:30,2023-08-26,S62384893,UPI/323802960783/192600/UPI/9369558521ybl/Paym,NA
CREDIT,UPI,500.0,1195.80,2023-08-26T19:42:29+05:30,2023-08-26,S63283598,UPI/323823651280/194229/UPI/rajanbhai271okhdfc,NA
CREDIT,UPI,700.0,1895.80,2023-08-26T20:36:16+05:30,2023-08-26,S65982118,UPI/323840766196/203616/UPI/shivampandit199999,NA
DEBIT,UPI,60.0,1835.80,2023-08-26T21:29:53+05:30,2023-08-26,S68128680,UPI/323842980662/212953/UPI/BHARATPE9006422859,NA
DEBIT,UPI,20.0,1815.80,2023-08-26T21:31:20+05:30,2023-08-26,S68172522,UPI/323858871474/213120/UPI/BHARATPE9006422859,NA
DEBIT,UPI,1.0,1814.80,2023-08-27T12:18:39+05:30,2023-08-27,S80702588,UPI/323980913734/121839/UPI/9455566771ibl/Paym,NA
DEBIT,UPI,1499.0,315.80,2023-08-27T12:19:54+05:30,2023-08-27,S80757332,UPI/323955508725/121953/UPI/9455566771ibl/Paym,NA
CREDIT,UPI,240.0,555.80,2023-08-27T19:29:38+05:30,2023-08-27,S97701259,UPI/323906382845/192938/UPI/atulyadav16469axl/,NA
CREDIT,OTHERS,850.0,1405.80,2023-08-28T20:27:41+05:30,2023-08-28,S41019806,IMPS/P2A/324020918876/PHONEPEPRIVATEL/IMPSAXB9111,NA
DEBIT,UPI,10.0,1395.80,2023-08-28T22:12:24+05:30,2023-08-28,S45408910,UPI/324042450488/221223/UPI/AMZN0013808700apl/,NA
DEBIT,UPI,1200.0,195.80,2023-08-29T11:49:00+05:30,2023-08-29,S57790074,UPI/324141523213/114859/UPI/6393130981ibl/Paym,NA
CREDIT,OTHERS,600.0,795.80,2023-08-29T20:02:21+05:30,2023-08-29,S81074239,IMPS/P2A/324120778985/PHONEPEPRIVATEL/IMPSAXB9111,NA
DEBIT,UPI,100.0,695.80,2023-08-29T20:16:40+05:30,2023-08-29,S81854961,UPI/324197515990/201639/UPI/9651400138ibl/Paym,NA
DEBIT,UPI,15.0,680.80,2023-08-30T04:20:30+05:30,2023-08-30,C49639415,UPI/360856222176/003529/UPI/JIOINAPPDIRECTybl/,NA
CREDIT,OTHERS,600.0,1280.80,2023-08-30T16:19:31+05:30,2023-08-30,S10234718,IMPS/P2A/324216087923/PHONEPEPRIVATEL/IMPSAXB9111,NA
CREDIT,OTHERS,170.0,1450.80,2023-08-30T20:28:31+05:30,2023-08-30,S22822792,IMPS/P2A/324220033063/PHONEPEPRIVATEL/IMPSAXB9111,NA
CREDIT,OTHERS,350.0,1800.80,2023-08-31T06:44:24+05:30,2023-08-31,S29321467,NEFT-AXNPN32436146561-PHONEPE PRIVATE LIMITED-PAYM,922020004688715
CREDIT,OTHERS,750.0,2550.80,2023-08-31T13:42:41+05:30,2023-08-31,S44452744,IMPS/P2A/324313262601/PHONEPEPRIVATEL/IMPSAXB9111,NA
CREDIT,UPI,1200.0,3750.80,2023-08-31T16:09:10+05:30,2023-08-31,S49825253,UPI/360922384154/160911/UPI/6393130981paytm/NA,NA
DEBIT,UPI,200.0,3550.80,2023-08-31T17:42:03+05:30,2023-08-31,S53800850,UPI/360913730269/174202/UPI/7007317430ybl/Paym,NA
DEBIT,UPI,50.0,3500.80,2023-08-31T17:46:36+05:30,2023-08-31,S53987372,UPI/360940991010/174635/UPI/Q564420176ybl/Paym,NA
DEBIT,UPI,3500.0,0.80,2023-09-01T10:42:42+05:30,2023-09-01,S73798851,UPI/324450376631/104241/UPI/KAYUMTRADERSicici/,NA
CREDIT,UPI,34.0,34.80,2023-09-03T18:19:09+05:30,2023-09-03,S77153314,UPI/361211837275/181909/UPI/8318404822ybl/Paym,NA
CREDIT,UPI,460.0,494.80,2023-09-04T12:10:17+05:30,2023-09-04,S1344345,UPI/324796646064/121018/UPI/akashk4478oksbi/UP,NA
DEBIT,UPI,200.0,294.80,2023-09-04T18:21:45+05:30,2023-09-04,S19162834,UPI/361301891758/182145/UPI/9794155540ybl/Paym,NA
CREDIT,OTHERS,850.0,1144.80,2023-09-04T19:40:41+05:30,2023-09-04,S23851712,IMPS/P2A/324719156719/PHONEPEPRIVATEL/IMPSAXB9111,NA
CREDIT,UPI,200.0,1344.80,2023-09-05T16:30:08+05:30,2023-09-05,S58447449,UPI/324834305504/163009/UPI/7310728269ibl/Paym,NA
CREDIT,OTHERS,1100.0,2444.80,2023-09-05T16:38:31+05:30,2023-09-05,S58842954,IMPS/P2A/324816104223/PHONEPEPRIVATEL/IMPSAXB9111,NA
DEBIT,UPI,10.0,2434.80,2023-09-06T10:13:26+05:30,2023-09-06,S84140894,UPI/324953058232/101326/UPI/9793976636paytm/Pa,NA
DEBIT,UPI,15.0,2419.80,2023-09-06T17:22:50+05:30,2023-09-06,S1765667,UPI/361567152277/172250/UPI/JIOINAPPDIRECTybl/,NA
DEBIT,UPI,220.0,2199.80,2023-09-08T19:37:29+05:30,2023-09-08,S89851665,UPI/325193535751/193728/UPI/BHARATPE9006231703,NA
DEBIT,UPI,500.0,1699.80,2023-09-08T19:39:31+05:30,2023-09-08,S89975898,UPI/325170177499/193930/UPI/BHARATPE9006231703,NA
CREDIT,OTHERS,850.0,2549.80,2023-09-08T20:21:01+05:30,2023-09-08,S92123207,IMPS/P2A/325120711629/PHONEPEPRIVATEL/IMPSAXB9111,NA
CREDIT,OTHERS,350.0,2899.80,2023-09-09T06:16:55+05:30,2023-09-09,S98844631,NEFT-AXNPN32522537728-PHONEPE PRIVATE LIMITED-PAYM,922020004688715
DEBIT,UPI,1.0,2898.80,2023-09-09T17:56:13+05:30,2023-09-09,S23158198,UPI/325249610577/175612/UPI/9910619719ibl/Paym,NA
DEBIT,UPI,499.0,2399.80,2023-09-09T17:56:53+05:30,2023-09-09,S23189784,UPI/361821005165/175653/UPI/9910619719ybl/Paym,NA
CREDIT,OTHERS,200.0,2599.80,2023-09-09T20:03:32+05:30,2023-09-09,S29678386,IMPS/P2A/325220633774/PHONEPEPRIVATEL/IMPSAXB9111,NA
DEBIT,UPI,10.0,2589.80,2023-09-11T21:53:54+05:30,2023-09-11,S16382909,UPI/362008912683/215353/UPI/9118603709ybl/Paym,NA
CREDIT,OTHERS,180.0,2769.80,2023-09-12T07:07:06+05:30,2023-09-12,S20182227,NEFT-AXNPN32551072344-PHONEPE PRIVATE LIMITED-PAYM,922020004688715
DEBIT,CARD,60.0,2709.80,2023-09-12T09:55:34+05:30,2023-09-12,S25018025,PRCR/MS NEHA FILLING STATIO/FARRUKHAB,NA
DEBIT,UPI,10.0,2699.80,2023-09-12T10:00:48+05:30,2023-09-12,S25206440,UPI/362117241971/100047/UPI/rlsrls611okaxis/UP,NA
DEBIT,UPI,20.0,2679.80,2023-09-12T10:11:04+05:30,2023-09-12,S25612137,UPI/325586543048/101104/UPI/918960343294paytm/,NA
CREDIT,OTHERS,350.0,3029.80,2023-09-13T06:36:06+05:30,2023-09-13,S61221395,NEFT-AXNPN32564161171-PHONEPE PRIVATE LIMITED-PAYM,922020004688715
DEBIT,UPI,3000.0,29.80,2023-09-13T10:19:32+05:30,2023-09-13,S67400576,UPI/362228688034/101932/UPI/kayumtradersicici/,NA
CREDIT,OTHERS,400.0,429.80,2023-09-13T19:25:01+05:30,2023-09-13,S92163252,IMPS/P2A/325619237951/PHONEPEPRIVATEL/IMPSAXB9111,NA
DEBIT,UPI,140.0,289.80,2023-09-14T10:18:25+05:30,2023-09-14,S8105743,UPI/325782067531/101824/UPI/yadavgarments01ici,NA
DEBIT,UPI,120.0,169.80,2023-09-14T10:24:31+05:30,2023-09-14,S8341478,UPI/325711128680/102431/UPI/q276211684ybl/UPI,NA
CREDIT,OTHERS,670.0,839.80,2023-09-14T19:29:31+05:30,2023-09-14,S32855767,IMPS/P2A/325719401444/PHONEPEPRIVATEL/IMPSAXB9111,NA
CREDIT,OTHERS,5500.0,6339.80,2023-09-14T21:14:51+05:30,2023-09-14,S38051220,IMPS/P2A/325721171918/PHONEPEPRIVATEL/IMPSAXB9111,NA
DEBIT,UPI,50.0,6289.80,2023-09-14T21:54:45+05:30,2023-09-14,S39553889,UPI/325764466374/215444/UPI/q281022332ybl/UPI,NA
CREDIT,OTHERS,580.0,6869.80,2023-09-15T19:33:11+05:30,2023-09-15,S74319456,IMPS/P2A/325819277159/PHONEPEPRIVATEL/IMPSAXB9111,NA
DEBIT,UPI,40.0,6829.80,2023-09-15T21:46:32+05:30,2023-09-15,S80853921,UPI/325814801338/214632/UPI/q480037413ybl/UPI,NA
CREDIT,OTHERS,400.0,7229.80,2023-09-15T23:26:41+05:30,2023-09-15,S82914368,IMPS/P2A/325823524705/PHONEPEPRIVATEL/IMPSAXB9111,NA
DEBIT,UPI,120.0,7109.80,2023-09-16T11:41:10+05:30,2023-09-16,S93668594,UPI/325939118698/114110/UPI/bharatpe9000335745,NA
DEBIT,UPI,110.0,6999.80,2023-09-16T20:16:42+05:30,2023-09-16,S16850212,UPI/362506341475/201642/UPI/q936188905ybl/UPI,NA
CREDIT,UPI,50.0,7049.80,2023-09-17T20:17:51+05:30,2023-09-17,S57286243,UPI/362682097837/201752/UPI/9140092527ybl/Paym,NA
DEBIT,UPI,19.0,7030.80,2023-09-17T20:34:56+05:30,2023-09-17,S58083046,UPI/362677666438/203455/UPI/JIOINAPPDIRECTybl/,NA
DEBIT,UPI,10.0,7020.80,2023-09-17T21:39:34+05:30,2023-09-17,S60618933,UPI/326031090121/213933/UPI/paytmqr281005050101,NA
DEBIT,UPI,241.0,6779.80,2023-09-18T22:24:38+05:30,2023-09-18,S2152518,UPI/362782511755/222438/UPI/JIOINAPPDIRECTybl/,NA
CREDIT,OTHERS,450.0,7229.80,2023-09-18T22:27:51+05:30,2023-09-18,S2241208,IMPS/P2A/326122069839/PHONEPEPRIVATEL/IMPSAXB9111,NA
DEBIT,UPI,60.0,7169.80,2023-09-20T04:51:17+05:30,2023-09-20,C68550271,UPI/362986065954/002806/UPI/jk3178023oksbi/UPI,NA
DEBIT,UPI,19.0,7150.80,2023-09-20T08:43:42+05:30,2023-09-20,S44586905,UPI/362936697320/084342/UPI/JIOINAPPDIRECTybl/,NA
DEBIT,UPI,50.0,7100.80,2023-09-20T22:19:24+05:30,2023-09-20,S79935171,UPI/362951515153/221923/UPI/bharatpe90725406876,NA
CREDIT,OTHERS,1550.0,8650.80,2023-09-21T06:38:19+05:30,2023-09-21,S81972494,NEFT-AXNPN32647896963-PHONEPE PRIVATE LIMITED-PAYM,922020004688715
DEBIT,UPI,3500.0,5150.80,2023-09-21T13:05:06+05:30,2023-09-21,S94489819,UPI/363099470087/130505/UPI/9910619719ybl/Paym,NA
CREDIT,UPI,1.0,5151.80,2023-09-21T18:29:38+05:30,2023-09-21,S7953606,UPI/326459300319/182939/UPI/8178328660ybl/Paym,NA
CREDIT,UPI,2500.0,7651.80,2023-09-21T19:28:25+05:30,2023-09-21,S11192322,UPI/326414745806/192825/UPI/8178328660ybl/Paym,NA
DEBIT,UPI,50.0,7601.80,2023-09-22T09:57:07+05:30,2023-09-22,S25137229,UPI/326557260830/095706/UPI/q936188905ybl/UPI,NA
DEBIT,UPI,1530.0,6071.80,2023-09-22T10:24:00+05:30,2023-09-22,S26148518,UPI/363118260318/102400/UPI/kayumtradersicici/,NA
DEBIT,UPI,2940.0,3131.80,2023-09-22T10:44:30+05:30,2023-09-22,S27314904,UPI/326594867550/104429/UPI/q201531625ybl/UPI,NA
DEBIT,UPI,500.0,2631.80,2023-09-22T18:56:41+05:30,2023-09-22,S50925382,UPI/326543680916/185641/UPI/q794239763ybl/UPI,NA
DEBIT,UPI,400.0,2231.80,2023-09-22T18:57:16+05:30,2023-09-22,S50959147,UPI/363160086306/185715/UPI/bharatpe9006655445,NA
DEBIT,UPI,140.0,2091.80,2023-09-22T21:52:38+05:30,2023-09-22,S59025095,UPI/363130387037/215238/UPI/paytm-71838008payt,NA
DEBIT,UPI,40.0,2051.80,2023-09-22T22:02:12+05:30,2023-09-22,S59359093,UPI/363183891268/220212/UPI/q503192015ybl/UPI,NA
CREDIT,OTHERS,1280.0,3331.80,2023-09-23T08:15:20+05:30,2023-09-23,S63173113,NEFT-AXNPN32663243361-PHONEPE PRIVATE LIMITED-PAYM,922020004688715
DEBIT,UPI,20.0,3311.80,2023-09-23T10:35:48+05:30,2023-09-23,S68034759,UPI/363206504523/103547/UPI/gpay-11217094612ok,NA
DEBIT,UPI,40.0,3271.80,2023-09-23T22:31:02+05:30,2023-09-23,S96558992,UPI/363240839054/223101/UPI/paytmqr281005050101,NA
DEBIT,UPI,17.0,3254.80,2023-09-23T22:48:48+05:30,2023-09-23,S96868152,UPI/326617042480/224848/UPI/bharatpe9006231702,NA
DEBIT,UPI,50.0,3204.80,2023-09-23T23:02:35+05:30,2023-09-23,S97057296,UPI/326611332361/230235/UPI/gpay-11225780335ok,NA
DEBIT,UPI,110.0,3094.80,2023-09-24T22:29:28+05:30,2023-09-24,S30361921,UPI/363370882645/222927/UPI/paytmqr281005050101,NA
CREDIT,OTHERS,1100.0,4194.80,2023-09-25T04:18:32+05:30,2023-09-25,S32068400,NEFT-AXNPN32689715249-PHONEPE PRIVATE LIMITED-PAYM,922020004688715
CREDIT,UPI,20.0,4214.80,2023-09-25T17:41:50+05:30,2023-09-25,S57029506,UPI/326845678397/174150/UPI/8423410441ybl/Paym,NA
DEBIT,UPI,20.0,4194.80,2023-09-25T20:14:00+05:30,2023-09-25,S65137615,UPI/363452618217/201400/UPI/paytmqr1m85w73nvep,NA
DEBIT,UPI,40.0,4154.80,2023-09-25T21:30:49+05:30,2023-09-25,S68701535,UPI/363413327004/213048/UPI/danishtt29okicici/,NA
DEBIT,UPI,1.0,4153.80,2023-09-26T10:00:52+05:30,2023-09-26,S77260285,UPI/326914825297/100052/UPI/9326476170axl/UPI,NA
DEBIT,UPI,3000.0,1153.80,2023-09-26T10:01:36+05:30,2023-09-26,S77287370,UPI/363526933147/100136/UPI/9326476170axl/UPI,NA
DEBIT,UPI,1000.0,153.80,2023-09-26T10:03:39+05:30,2023-09-26,S77362219,UPI/363512925930/100339/UPI/9326476170axl/UPI,NA
CREDIT,UPI,400.0,553.80,2023-09-26T14:00:53+05:30,2023-09-26,S87223444,UPI/326955781096/140054/UPI/pammapamma651okhdf,NA
DEBIT,UPI,30.0,523.80,2023-09-27T10:08:11+05:30,2023-09-27,S16287641,UPI/363632967626/100810/UPI/918960343294paytm/,NA
CREDIT,UPI,200.0,723.80,2023-09-27T12:06:05+05:30,2023-09-27,S21432101,UPI/327056465788/120606/UPI/7786043828axl/Paym,NA
DEBIT,UPI,200.0,523.80,2023-09-27T12:06:19+05:30,2023-09-27,S21445103,UPI/327092966148/120619/UPI/q794239763ybl/UPI,NA
DEBIT,UPI,200.0,323.80,2023-09-27T12:09:21+05:30,2023-09-27,S21572478,UPI/327060881675/120921/UPI/7668144294ybl/UPI,NA
CREDIT,OTHERS,400.0,723.80,2023-09-27T13:34:24+05:30,2023-09-27,S26099502,NEFT-AXNPN32707366582-PHONEPE PRIVATE LIMITED-PAYM,922020004688715
DEBIT,UPI,100.0,623.80,2023-09-27T20:11:21+05:30,2023-09-27,S44959822,UPI/363674299469/201120/UPI/salmanisohail316ok,NA
CREDIT,OTHERS,1450.0,2073.80,2023-09-28T08:00:14+05:30,2023-09-28,S52838514,NEFT-AXNPN32718772376-PHONEPE PRIVATE LIMITED-PAYM,922020004688715
DEBIT,UPI,1280.0,793.80,2023-09-28T12:13:59+05:30,2023-09-28,S61675993,UPI/327126113100/121359/UPI/9326476170axl/UPI,NA
DEBIT,UPI,10.0,783.80,2023-09-28T21:21:56+05:30,2023-09-28,S84281424,UPI/363705428996/212156/UPI/q151916609ybl/UPI,NA
CREDIT,OTHERS,600.0,1383.80,2023-09-29T06:42:54+05:30,2023-09-29,S87688894,NEFT-AXNPN32721951358-PHONEPE PRIVATE LIMITED-PAYM,922020004688715
DEBIT,UPI,500.0,883.80,2023-09-29T20:23:42+05:30,2023-09-29,S19974055,UPI/363815361019/202341/UPI/8795417446ybl/UPI,NA
CREDIT,OTHERS,480.0,1363.80,2023-09-30T06:09:28+05:30,2023-09-30,S25830699,NEFT-AXNPN32735104122-PHONEPE PRIVATE LIMITED-PAYM,922020004688715
DEBIT,UPI,150.0,1213.80,2023-09-30T21:19:06+05:30,2023-09-30,S62338065,UPI/363929704457/211906/UPI/paytm-71838008payt,NA
DEBIT,UPI,35.0,1178.80,2023-09-30T21:39:14+05:30,2023-09-30,S63069008,UPI/327356912025/213914/UPI/paytmqr1gjcuetfgap,NA
DEBIT,UPI,130.0,1048.80,2023-09-30T21:43:00+05:30,2023-09-30,S63191656,UPI/327382107529/214259/UPI/q179490663ybl/UPI,NA
DEBIT,UPI,50.0,998.80,2023-09-30T22:29:23+05:30,2023-09-30,S64528772,UPI/327310404873/222923/UPI/bharatpe9006767980,NA
DEBIT,UPI,10.0,988.80,2023-09-30T22:33:15+05:30,2023-09-30,S64627143,UPI/327309504550/223315/UPI/amzn0009916130apl/,NA
CREDIT,OTHERS,700.0,1688.80,2023-10-01T10:23:16+05:30,2023-10-01,S71173140,NEFT-AXNPN32748433244-PHONEPE PRIVATE LIMITED-PAYM,922020004688715
CREDIT,OTHERS,4550.0,6238.80,2023-10-01T19:02:22+05:30,2023-10-01,S92940459,IMPS/P2A/327419437183/PHONEPEPRIVATEL/IMPSAXB9111,NA
DEBIT,UPI,1.0,6237.80,2023-10-01T19:49:12+05:30,2023-10-01,S95566638,UPI/364067140409/194911/UPI/saxenajitender07ok,NA
DEBIT,UPI,4000.0,2237.80,2023-10-01T19:51:09+05:30,2023-10-01,S95670734,UPI/364082046583/195110/UPI/saxenajitender07ok,NA
DEBIT,UPI,540.0,1697.80,2023-10-01T20:16:47+05:30,2023-10-01,S96954758,UPI/364053437763/201647/UPI/bharatpe9006727091,NA
DEBIT,UPI,50.0,1647.80,2023-10-01T22:29:54+05:30,2023-10-01,S1619182,UPI/364013049968/222954/UPI/bharatpe9006422859,NA
CREDIT,OTHERS,540.0,2187.80,2023-10-02T02:55:44+05:30,2023-10-01,C79481990,IMPS/P2A/327423909113/PHONEPEPRIVATEL/IMPSAXB9111,NA
DEBIT,UPI,370.0,1817.80,2023-10-02T17:03:10+05:30,2023-10-02,S27185032,UPI/364120371370/170311/UPI/paytmqr13xcfctgk9p,NA
DEBIT,UPI,19.0,1798.80,2023-10-03T00:38:08+05:30,2023-10-03,C80957648,UPI/364271967098/000018/UPI/JIOINAPPDIRECTybl/,NA
CREDIT,OTHERS,600.0,2398.80,2023-10-03T03:56:11+05:30,2023-10-03,S43479009,NEFT-AXNPN32764818020-PHONEPE PRIVATE LIMITED-PAYM,922020004688715
DEBIT,UPI,10.0,2388.80,2023-10-03T20:25:12+05:30,2023-10-03,S83013108,UPI/364212216626/202514/UPI/q140453235ybl/UPI,NA
CREDIT,OTHERS,250.0,2638.80,2023-10-04T08:40:35+05:30,2023-10-04,S92804490,NEFT-AXNPN32778269663-PHONEPE PRIVATE LIMITED-PAYM,922020004688715
DEBIT,UPI,40.0,2598.80,2023-10-04T09:53:09+05:30,2023-10-04,S95678357,UPI/327708234724/095309/UPI/q715088262ybl/UPI,NA
DEBIT,UPI,10.0,2588.80,2023-10-04T09:59:59+05:30,2023-10-04,S95944316,UPI/327758234093/100000/UPI/q381977394ybl/UPI,NA
DEBIT,UPI,30.0,2558.80,2023-10-04T21:14:16+05:30,2023-10-04,S30546232,UPI/364351068214/211417/UPI/q103473263ybl/UPI,NA
CREDIT,OTHERS,400.0,2958.80,2023-10-05T07:29:40+05:30,2023-10-05,S36781684,NEFT-AXNPN32781741064-PHONEPE PRIVATE LIMITED-PAYM,922020004688715
CREDIT,UPI,200.0,3158.80,2023-10-05T18:48:46+05:30,2023-10-05,S69142972,UPI/327899560520/184846/UPI/mr2484066okaxis/UP,NA
DEBIT,UPI,30.0,3128.80,2023-10-05T19:56:08+05:30,2023-10-05,S73538830,UPI/327836712991/195607/UPI/9696661374ybl/UPI,NA
DEBIT,UPI,160.0,2968.80,2023-10-05T20:26:51+05:30,2023-10-05,S75291455,UPI/327849011904/202651/UPI/q779593978ybl/UPI,NA
DEBIT,UPI,226.0,2742.80,2023-10-06T13:24:14+05:30,2023-10-06,S96834019,UPI/327954639406/132413/UPI/q810644723ybl/UPI,NA
DEBIT,UPI,320.0,2422.80,2023-10-06T14:14:20+05:30,2023-10-06,S99161147,UPI/327902036646/141420/UPI/bharatpe9006615350,NA
DEBIT,UPI,10.0,2412.80,2023-10-06T16:20:57+05:30,2023-10-06,S4708973,UPI/364546141627/162059/UPI/q140453235ybl/UPI,NA
CREDIT,UPI,700.0,3112.80,2023-10-06T18:09:14+05:30,2023-10-06,S10246605,UPI/364515185408/180917/UPI/9837552268ybl/Paym,NA
DEBIT,UPI,220.0,2892.80,2023-10-06T21:27:38+05:30,2023-10-06,S21372494,UPI/364575268892/212738/UPI/bharatpe9006727091,NA
CREDIT,UPI,220.0,3112.80,2023-10-06T21:30:07+05:30,2023-10-06,S21465099,UPI/327996855768/213010/UPI/9315118386ibl/Paym,NA
DEBIT,UPI,30.0,3082.80,2023-10-06T21:32:04+05:30,2023-10-06,S21536771,UPI/364585267321/213206/UPI/q689244156ybl/UPI,NA
CREDIT,OTHERS,2330.0,5412.80,2023-10-07T09:01:11+05:30,2023-10-07,S28822250,NEFT-AXNPN32809040627-PHONEPE PRIVATE LIMITED-PAYM,922020004688715
DEBIT,UPI,19.0,5393.80,2023-10-07T15:57:03+05:30,2023-10-07,S47219816,UPI/364623096305/155702/UPI/gpaybillpayrchg2a,NA
DEBIT,UPI,2000.0,3393.80,2023-10-07T18:44:21+05:30,2023-10-07,S55892736,UPI/364663104214/184423/UPI/bharatpe9006655445,NA
DEBIT,UPI,20.0,3373.80,2023-10-07T21:17:18+05:30,2023-10-07,S64423190,UPI/364626518479/211718/UPI/q901958227ybl/UPI,NA
DEBIT,UPI,330.0,3043.80,2023-10-07T21:32:00+05:30,2023-10-07,S65016956,UPI/328022118440/213159/UPI/q424409550ybl/UPI,NA
CREDIT,UPI,1900.0,4943.80,2023-10-08T20:10:05+05:30,2023-10-08,S107106,UPI/364771401449/201008/UPI/8795417446ybl/Paym,NA
DEBIT,UPI,100.0,4843.80,2023-10-08T22:26:18+05:30,2023-10-08,S4769330,UPI/328111067339/222618/UPI/bharatpe9006568942,NA
CREDIT,OTHERS,100.0,4943.80,2023-10-09T05:24:05+05:30,2023-10-09,S6299057,NEFT-AXNPN32826017756-PHONEPE PRIVATE LIMITED-PAYM,922020004688715
DEBIT,UPI,2000.0,2943.80,2023-10-09T11:24:18+05:30,2023-10-09,S17700145,UPI/364865081071/112420/UPI/saxenajitender07ok,NA
DEBIT,UPI,50.0,2893.80,2023-10-09T14:39:20+05:30,2023-10-09,S26894300,UPI/328267086594/143920/UPI/bharatpe09904732784,NA
CREDIT,UPI,100.0,2993.80,2023-10-09T20:02:16+05:30,2023-10-09,S41053867,UPI/364879513820/200219/UPI/8795417446ybl/Paym,NA
DEBIT,UPI,110.0,2883.80,2023-10-09T22:31:10+05:30,2023-10-09,S46892561,UPI/364866917902/223110/UPI/bharatpe9006304992,NA
CREDIT,OTHERS,100.0,2983.80,2023-10-10T06:44:35+05:30,2023-10-10,S49223531,NEFT-AXNPN32839436761-PHONEPE PRIVATE LIMITED-PAYM,922020004688715
DEBIT,UPI,20.0,2963.80,2023-10-10T16:09:40+05:30,2023-10-10,S73457435,UPI/364989040958/160939/UPI/bharatpe9006593890,NA
DEBIT,UPI,5.0,2958.80,2023-10-10T19:19:48+05:30,2023-10-10,S84052086,UPI/364995451099/191947/UPI/q389513966ybl/UPI,NA
DEBIT,UPI,310.0,2648.80,2023-10-10T20:31:14+05:30,2023-10-10,S88248536,UPI/364974354661/203113/UPI/paytm-71838008payt,NA
DEBIT,UPI,500.0,2148.80,2023-10-11T06:06:22+05:30,2023-10-11,S94827249,UPI/328413464323/060621/UPI/rs97936734-3okhdfc,NA
CREDIT,OTHERS,250.0,2398.80,2023-10-11T06:09:47+05:30,2023-10-11,S94860882,NEFT-AXNPN32843162277-PHONEPE PRIVATE LIMITED-PAYM,922020004688715
DEBIT,UPI,100.0,2298.80,2023-10-11T18:47:34+05:30,2023-10-11,S25403142,UPI/365068252768/184733/UPI/8795417446ybl/Paym,NA
DEBIT,UPI,120.0,2178.80,2023-10-11T21:22:07+05:30,2023-10-11,S33611731,UPI/365040008425/212207/UPI/paytm-71838008payt,NA
DEBIT,UPI,100.0,2078.80,2023-10-11T22:25:46+05:30,2023-10-11,S35705905,UPI/365093613662/222546/UPI/subhan2023ibl/UPI,NA
CREDIT,OTHERS,1000.0,3078.80,2023-10-12T05:49:08+05:30,2023-10-12,S37601231,NEFT-AXNPN32856873127-PHONEPE PRIVATE LIMITED-PAYM,922020004688715
CREDIT,UPI,200.0,3278.80,2023-10-12T18:25:53+05:30,2023-10-12,S66280849,UPI/328501902949/182553/UPI/9696594120ibl/Paym,NA
CREDIT,OTHERS,600.0,3878.80,2023-10-13T05:50:40+05:30,2023-10-13,S79716428,NEFT-AXNPN32860530042-PHONEPE PRIVATE LIMITED-PAYM,922020004688715
DEBIT,UPI,10.0,3868.80,2023-10-14T17:43:39+05:30,2023-10-14,S48856280,UPI/365307354802/174339/UPI/q110622524ybl/UPI,NA
DEBIT,UPI,1000.0,2868.80,2023-10-14T19:43:33+05:30,2023-10-14,S55213038,UPI/328750382900/194332/UPI/bharatpe9006655445,NA
DEBIT,UPI,10.0,2858.80,2023-10-14T20:33:18+05:30,2023-10-14,S57644844,UPI/365331085304/203317/UPI/paytmqr281005050101,NA
DEBIT,UPI,55.0,2803.80,2023-10-15T09:21:09+05:30,2023-10-15,S67997746,UPI/328805792827/092109/UPI/q936188905ybl/UPI,NA
DEBIT,UPI,300.0,2503.80,2023-10-15T10:15:59+05:30,2023-10-15,S70051927,UPI/328833000472/101558/UPI/guptanitun535ybl/U,NA
DEBIT,UPI,510.0,1993.80,2023-10-15T19:48:41+05:30,2023-10-15,S95321339,UPI/328853539258/194841/UPI/bharatpe8001288418,NA
DEBIT,UPI,50.0,1943.80,2023-10-15T21:25:58+05:30,2023-10-15,S99299837,UPI/328822844956/212557/UPI/paytmqr19n6wlxt7dp,NA
CREDIT,OTHERS,1300.0,3243.80,2023-10-16T04:21:01+05:30,2023-10-16,S2219264,NEFT-AXNPN32891631905-PHONEPE PRIVATE LIMITED-PAYM,922020004688715
DEBIT,UPI,1000.0,2243.80,2023-10-16T21:06:29+05:30,2023-10-16,S40864951,UPI/328975031412/210628/UPI/9315118386ibl/Paym,NA
DEBIT,UPI,241.0,2002.80,2023-10-17T08:59:52+05:30,2023-10-17,S48742388,UPI/365644501448/085951/UPI/JIOINAPPDIRECTybl/,NA
CREDIT,OTHERS,950.0,2952.80,2023-10-17T09:06:20+05:30,2023-10-17,S48953083,NEFT-AXNPN32905135003-PHONEPE PRIVATE LIMITED-PAYM,922020004688715
CREDIT,OTHERS,930.0,3882.80,2023-10-18T06:21:47+05:30,2023-10-18,S87130159,NEFT-AXNPN32919277330-PHONEPE PRIVATE LIMITED-PAYM,922020004688715
DEBIT,UPI,25.0,3857.80,2023-10-19T19:33:18+05:30,2023-10-19,S61724773,UPI/329259529659/193317/UPI/khanfhajluokicici/,NA
DEBIT,UPI,10.0,3847.80,2023-10-19T21:17:05+05:30,2023-10-19,S66688328,UPI/329247234363/211704/UPI/q329690445ybl/UPI,NA
DEBIT,UPI,500.0,3347.80,2023-10-20T21:01:58+05:30,2023-10-20,S9381222,UPI/329316780425/210158/UPI/7267953323airtel/P,NA
DEBIT,UPI,40.0,3307.80,2023-10-20T21:48:13+05:30,2023-10-20,S11122589,UPI/365971883324/214812/UPI/q936188905ybl/UPI,NA
CREDIT,OTHERS,830.0,4137.80,2023-10-21T08:07:00+05:30,2023-10-21,S15467276,NEFT-AXNPN32940698673-PHONEPE PRIVATE LIMITED-PAYM,922020004688715
DEBIT,UPI,3300.0,837.80,2023-10-21T16:17:48+05:30,2023-10-21,S36107080,UPI/366040718841/161747/UPI/gpay-11166221636ok,NA
DEBIT,UPI,136.0,701.80,2023-10-21T17:20:22+05:30,2023-10-21,S39030543,UPI/366061027398/172021/UPI/0795135a0101881bqr,NA
DEBIT,UPI,200.0,501.80,2023-10-22T22:06:51+05:30,2023-10-22,S89653788,UPI/366134802258/220650/UPI/q864587349ybl/UPI,NA
DEBIT,UPI,10.0,491.80,2023-10-22T22:10:53+05:30,2023-10-22,S89725892,UPI/329580596520/221053/UPI/q186550817ybl/UPI,NA
CREDIT,OTHERS,270.0,761.80,2023-10-23T05:15:32+05:30,2023-10-23,S91497746,NEFT-AXNPN32968158203-PHONEPE PRIVATE LIMITED-PAYM,922020004688715
DEBIT,UPI,20.0,741.80,2023-10-23T20:20:39+05:30,2023-10-23,S24782936,UPI/366269742844/202039/UPI/bharatpe9006046806,NA
CREDIT,UPI,100.0,841.80,2023-10-23T22:23:15+05:30,2023-10-23,S28922842,UPI/329687708432/222316/UPI/9315118386ibl/Paym,NA
DEBIT,UPI,150.0,691.80,2023-10-23T22:27:34+05:30,2023-10-23,S29021496,UPI/329697903905/222734/UPI/BHARATPE9006568942,NA
CREDIT,OTHERS,250.0,941.80,2023-10-24T06:17:13+05:30,2023-10-24,S30672802,NEFT-AXNPN32971658637-PHONEPE PRIVATE LIMITED-PAYM,922020004688715
DEBIT,UPI,43.0,898.80,2023-10-24T18:22:57+05:30,2023-10-24,S55252861,UPI/366363685330/182256/UPI/q013670964ybl/UPI,NA
CREDIT,UPI,100.0,998.80,2023-10-24T20:45:13+05:30,2023-10-24,S61334254,UPI/329719192683/204514/UPI/pranshusrivastava85,NA
DEBIT,UPI,150.0,848.80,2023-10-24T20:48:08+05:30,2023-10-24,S61433227,UPI/329719297164/204808/UPI/paytm-77691271payt,NA
DEBIT,UPI,30.0,818.80,2023-10-24T20:53:45+05:30,2023-10-24,S61625888,UPI/366359405086/205345/UPI/bharatpe9006792164,NA
DEBIT,UPI,20.0,798.80,2023-10-24T20:54:12+05:30,2023-10-24,S61640885,UPI/329736201165/205411/UPI/bharatpe9006792164,NA
DEBIT,UPI,200.0,598.80,2023-10-24T22:17:04+05:30,2023-10-24,S63885103,UPI/329759006764/221703/UPI/9264998949barodamp,NA
CREDIT,OTHERS,1000.0,1598.80,2023-10-25T07:43:32+05:30,2023-10-25,S66749427,NEFT-AXNPN32985362621-PHONEPE PRIVATE LIMITED-PAYM,922020004688715
DEBIT,UPI,60.0,1538.80,2023-10-25T09:34:57+05:30,2023-10-25,S69874019,UPI/366409912237/093457/UPI/a319484354okaxis/U,NA
DEBIT,UPI,19.0,1519.80,2023-10-25T23:04:59+05:30,2023-10-25,S5046152,UPI/366454370176/230459/UPI/JIOINAPPDIRECTybl/,NA
DEBIT,UPI,10.0,1509.80,2023-10-26T21:05:53+05:30,2023-10-26,S42129327,UPI/366551069727/210553/UPI/q186550817ybl/UPI,NA
CREDIT,OTHERS,400.0,1909.80,2023-10-28T06:43:43+05:30,2023-10-28,S87259933,NEFT-AXNPN33016178125-PHONEPE PRIVATE LIMITED-PAYM,922020004688715
DEBIT,UPI,239.0,1670.80,2023-10-28T12:03:13+05:30,2023-10-28,S97369105,UPI/366794724352/120313/UPI/euronetgpayrchici,NA
CREDIT,UPI,400.0,2070.80,2023-10-28T16:41:49+05:30,2023-10-28,S9224664,UPI/366728204872/164150/UPI/914009252754paytm/,NA
DEBIT,UPI,310.0,1760.80,2023-10-28T16:54:58+05:30,2023-10-28,S9903130,UPI/330157941591/165458/UPI/paytm-71838958payt,NA
DEBIT,UPI,215.0,1545.80,2023-10-28T18:27:02+05:30,2023-10-28,S14121732,UPI/366717747805/182702/UPI/9794155540ybl/UPI,NA
CREDIT,OTHERS,2.0,1547.80,2023-10-30T11:04:29+05:30,2023-10-30,S68900750,NEFT-AXNPN33033295421-PHONEPE PRIVATE LIMITED-PAYM,922020004688715
DEBIT,UPI,22.0,1525.80,2023-10-30T14:07:52+05:30,2023-10-30,S77379920,UPI/330356014618/140752/UPI/gopalbatham796axl/,NA
CREDIT,UPI,200.0,1725.80,2023-10-30T18:53:51+05:30,2023-10-30,S90927614,UPI/330335699567/185352/UPI/7458942407ibl/Paym,NA
DEBIT,UPI,200.0,1525.80,2023-10-30T19:34:47+05:30,2023-10-30,S93159188,UPI/366945827827/193447/UPI/bharatpe9006655445,NA
DEBIT,UPI,30.0,1495.80,2023-10-31T18:16:36+05:30,2023-10-31,S30457808,UPI/330458355752/181636/UPI/bharatpe9006870678,NA
DEBIT,UPI,145.0,1350.80,2023-11-01T22:30:10+05:30,2023-11-01,S88937039,UPI/367169833101/223010/UPI/q507904675ybl/UPI,NA
CREDIT,OTHERS,280.0,1630.80,2023-11-02T06:55:07+05:30,2023-11-02,S91522381,NEFT-AXNPN33065053054-PHONEPE PRIVATE LIMITED-PAYM,922020004688715
DEBIT,UPI,500.0,1130.80,2023-11-02T13:17:18+05:30,2023-11-02,S8059426,UPI/330618739362/131718/UPI/shivampandit199999,NA
DEBIT,UPI,10.0,1120.80,2023-11-02T18:28:02+05:30,2023-11-02,S23196652,UPI/330604359165/182801/UPI/9807647518okbizaxi,NA
DEBIT,UPI,150.0,970.80,2023-11-02T20:51:14+05:30,2023-11-02,S31159227,UPI/367217173942/205114/UPI/paytmqr1th7lt1rdwp,NA
DEBIT,UPI,60.0,910.80,2023-11-03T06:02:22+05:30,2023-11-03,S36309557,UPI/330785682965/060222/UPI/paytm-79496683payt,NA
DEBIT,UPI,180.0,730.80,2023-11-03T08:18:46+05:30,2023-11-03,S38621012,UPI/330784878813/081845/UPI/7011743393ybl/UPI,NA
DEBIT,UPI,500.0,230.80,2023-11-04T15:57:51+05:30,2023-11-04,S2568744,UPI/367463638385/155751/UPI/q390207955ybl/UPI,NA
DEBIT,UPI,19.0,211.80,2023-11-04T20:26:16+05:30,2023-11-04,S17185403,UPI/330891563651/202616/UPI/billdeskrechargei,NA
DEBIT,UPI,20.0,191.80,2023-11-05T21:15:06+05:30,2023-11-05,S61083472,UPI/330958305176/211505/UPI/q927634233ybl/UPI,NA
CREDIT,UPI,200.0,391.80,2023-11-06T19:20:31+05:30,2023-11-06,S1823220,UPI/331098721834/192032/UPI/7458942407ibl/Paym,NA
DEBIT,UPI,200.0,191.80,2023-11-06T20:12:28+05:30,2023-11-06,S4811942,UPI/367639159047/201228/UPI/goldykashyap1992ok,NA
DEBIT,UPI,105.0,86.80,2023-11-06T20:57:40+05:30,2023-11-06,S7168261,UPI/367615460861/205740/UPI/q507904675ybl/UPI,NA
CREDIT,OTHERS,1150.0,1236.80,2023-11-07T09:13:37+05:30,2023-11-07,S16491671,NEFT-AXNPN33115403433-PHONEPE PRIVATE LIMITED-PAYM,922020004688715
DEBIT,UPI,51.0,1185.80,2023-11-07T10:18:24+05:30,2023-11-07,S19217606,UPI/331159783161/101823/UPI/q329690445ybl/UPI,NA
DEBIT,UPI,500.0,685.80,2023-11-07T20:03:09+05:30,2023-11-07,S50491400,UPI/331138208481/200309/UPI/9306981930axl/UPI,NA
DEBIT,UPI,10.0,675.80,2023-11-07T21:02:32+05:30,2023-11-07,S53687519,UPI/367745798119/210232/UPI/q361501502ybl/UPI,NA
DEBIT,UPI,50.0,625.80,2023-11-07T21:44:01+05:30,2023-11-07,S55460374,UPI/331129808698/214400/UPI/q329690445ybl/UPI,NA
CREDIT,OTHERS,250.0,875.80,2023-11-08T13:19:19+05:30,2023-11-08,S76725040,NEFT-AXNPN33121803511-PHONEPE PRIVATE LIMITED-PAYM,922020004688715
CREDIT,UPI,180.0,1055.80,2023-11-08T15:21:21+05:30,2023-11-08,S83356502,UPI/331239380432/152122/UPI/9315118386ibl/Paym,NA
CREDIT,OTHERS,15.0,1070.80,2023-11-08T17:41:05+05:30,2023-10-31,S90687471,51888100006461IntPd01-08-2023 to 31-10-2023,NA
DEBIT,UPI,50.0,1020.80,2023-11-08T21:33:05+05:30,2023-11-08,S4089921,UPI/331283052678/213305/UPI/mosoyamalamicici/U,NA
CREDIT,OTHERS,2950.0,3970.80,2023-11-09T15:29:37+05:30,2023-11-09,S31204569,NEFT-AXNPN33134581345-PHONEPE PRIVATE LIMITED-PAYM,922020004688715
CREDIT,UPI,200.0,4170.80,2023-11-09T16:56:28+05:30,2023-11-09,S35943473,UPI/331316876773/165628/UPI/gopalbatham796axl/,NA
DEBIT,UPI,140.0,4030.80,2023-11-09T22:32:53+05:30,2023-11-09,S54601759,UPI/331383306148/223253/UPI/q507904675ybl/UPI,NA
CREDIT,OTHERS,10.0,4040.80,2023-11-10T09:12:21+05:30,2023-11-10,S60575729,NEFT-AXNPN33149187715-PHONEPE PRIVATE LIMITED-PAYM,922020004688715
DEBIT,UPI,1250.0,2790.80,2023-11-10T13:36:10+05:30,2023-11-10,S75770363,UPI/331474232749/133610/UPI/paytmqr1vp81ku8tgp,NA
DEBIT,UPI,50.0,2740.80,2023-11-10T22:05:31+05:30,2023-11-10,S5781141,UPI/368019110714/220531/UPI/gopalbatham796axl/,NA
CREDIT,OTHERS,3440.0,6180.80,2023-11-11T09:53:51+05:30,2023-11-11,S13734388,NEFT-AXNPN33153901636-PHONEPE PRIVATE LIMITED-PAYM,922020004688715
DEBIT,UPI,40.0,6140.80,2023-11-11T21:20:25+05:30,2023-11-11,S52697950,UPI/331538016834/212025/UPI/q361501502ybl/UPI,NA
DEBIT,UPI,120.0,6020.80,2023-11-11T21:59:53+05:30,2023-11-11,S54067435,UPI/331531726174/215952/UPI/paytm-71838008payt,NA
DEBIT,UPI,30.0,5990.80,2023-11-11T22:08:55+05:30,2023-11-11,S54329899,UPI/368145717050/220854/UPI/paytmqr19n6wlxt7dp,NA
CREDIT,UPI,170.0,6160.80,2023-11-12T02:29:54+05:30,2023-11-11,C12486927,UPI/331588799730/233230/UPI/9315118386ibl/Paym,NA
DEBIT,UPI,330.0,5830.80,2023-11-12T02:30:36+05:30,2023-11-11,C12523383,UPI/368183521533/233544/UPI/Q507904675ybl/Paym,NA
CREDIT,OTHERS,4730.0,10560.80,2023-11-12T06:36:51+05:30,2023-11-12,S57095035,NEFT-AXNPN33168292220-PHONEPE PRIVATE LIMITED-PAYM,922020004688715
DEBIT,UPI,1660.0,8900.80,2023-11-12T11:26:03+05:30,2023-11-12,S66834486,UPI/331678735052/112602/UPI/im201012606844ind,NA
DEBIT,UPI,50.0,8850.80,2023-11-12T17:41:52+05:30,2023-11-12,S87776442,UPI/331654358281/174151/UPI/saxenaatul73okaxis,NA
DEBIT,UPI,1500.0,7350.80,2023-11-12T18:28:28+05:30,2023-11-12,S90611968,UPI/331676959597/182827/UPI/shukaabhishek1oksb,NA
DEBIT,UPI,420.0,6930.80,2023-11-13T16:06:13+05:30,2023-11-13,S20896710,UPI/331758181227/160612/UPI/bharatpe9006194556,NA
DEBIT,UPI,300.0,6630.80,2023-11-13T19:25:03+05:30,2023-11-13,S30449986,UPI/368343094369/192502/UPI/paytmqr1ny3qn38lnp,NA
DEBIT,UPI,500.0,6130.80,2023-11-13T19:29:52+05:30,2023-11-13,S30663307,UPI/331700289823/192952/UPI/paytmqr1ny3qn38lnp,NA
DEBIT,UPI,239.0,5891.80,2023-11-14T09:38:19+05:30,2023-11-14,S42191596,UPI/331845503012/093818/UPI/euronetgpayrchici,NA
CREDIT,UPI,1.0,5892.80,2023-11-14T17:23:20+05:30,2023-11-14,S62190809,UPI/331830889030/172320/UPI/aditya9450203ybl/P,NA
CREDIT,UPI,1.0,5893.80,2023-11-14T18:29:20+05:30,2023-11-14,S65497752,UPI/331873302771/182921/UPI/311999sshuklaaxl/P,NA
CREDIT,UPI,37999.0,43892.80,2023-11-14T18:31:11+05:30,2023-11-14,S65593249,UPI/331812106847/183112/UPI/311999sshuklaaxl/P,NA
DEBIT,UPI,1.0,43891.80,2023-11-14T18:47:58+05:30,2023-11-14,S66419723,UPI/331818919138/184758/UPI/7007674186paytm/UP,NA
DEBIT,UPI,16500.0,27391.80,2023-11-14T18:49:41+05:30,2023-11-14,S66498670,UPI/331814821452/184941/UPI/7007674186paytm/UP,NA
DEBIT,UPI,2000.0,25391.80,2023-11-14T19:20:37+05:30,2023-11-14,S67942941,UPI/331872621357/192036/UPI/katiyarabhishek7a,NA
DEBIT,UPI,340.0,25051.80,2023-11-14T19:55:21+05:30,2023-11-14,S69420347,UPI/331831822934/195521/UPI/paytm-71838008payt,NA
DEBIT,UPI,80.0,24971.80,2023-11-14T20:36:09+05:30,2023-11-14,S71155792,UPI/331823130613/203608/UPI/q096036225ybl/UPI,NA
DEBIT,UPI,2000.0,22971.80,2023-11-15T12:10:30+05:30,2023-11-15,S87235066,UPI/368570135513/121029/UPI/badmashthakurybl/P,NA
CREDIT,UPI,2000.0,24971.80,2023-11-15T12:10:31+05:30,2023-11-15,S87237968,UPI/368570135513/121030/REVERSAL,NA
DEBIT,UPI,2000.0,22971.80,2023-11-15T12:16:22+05:30,2023-11-15,S87508128,UPI/368565651432/121622/UPI/saurabhmathur829977,NA
DEBIT,UPI,1.0,22970.80,2023-11-15T17:44:34+05:30,2023-11-15,S7026781,UPI/368573968966/174433/UPI/8905552611ikwik/UP,NA
DEBIT,UPI,10000.0,12970.80,2023-11-15T17:48:21+05:30,2023-11-15,S7201813,UPI/368589163186/174821/UPI/8905552611ikwik/UP,NA
DEBIT,UPI,500.0,12470.80,2023-11-15T19:08:47+05:30,2023-11-15,S12023935,UPI/331940570085/190846/UPI/mohitkingguptaoksb,NA
DEBIT,UPI,10.0,12460.80,2023-11-15T20:56:36+05:30,2023-11-15,S16568713,UPI/368530075516/205636/UPI/q186550817ybl/UPI,NA
CREDIT,OTHERS,1320.0,13780.80,2023-11-16T05:34:18+05:30,2023-11-16,S20622006,NEFT-AXNPN33203710382-PHONEPE PRIVATE LIMITED-PAYM,922020004688715
CREDIT,UPI,400.0,14180.80,2023-11-16T12:33:01+05:30,2023-11-16,S32337925,UPI/368618153232/123302/UPI/payoutspaytm/20231,NA
DEBIT,UPI,1000.0,13180.80,2023-11-16T14:11:07+05:30,2023-11-16,S37108945,UPI/332001084850/141107/UPI/dadashakti1983okic,NA
CREDIT,CASH,45000.0,58180.80,2023-11-16T15:51:14+05:30,2023-11-16,00707977,BY CASH,NA
CREDIT,OTHERS,270.0,58450.80,2023-11-17T05:08:11+05:30,2023-11-17,S59989067,NEFT-AXNPN33217638945-PHONEPE PRIVATE LIMITED-PAYM,922020004688715
DEBIT,UPI,50.0,58400.80,2023-11-17T08:58:36+05:30,2023-11-17,S62814042,UPI/368779711199/085836/UPI/paytmqr1085faiqrwp,NA
DEBIT,UPI,2000.0,56400.80,2023-11-17T12:15:26+05:30,2023-11-17,S70975125,UPI/368792228881/121526/UPI/rajatdixit11223-1o,NA
DEBIT,UPI,21000.0,35400.80,2023-11-17T16:34:54+05:30,2023-11-17,S82212459,UPI/332126038252/163454/UPI/msjsrfashioneazypa,NA
DEBIT,UPI,5200.0,30200.80,2023-11-17T18:32:29+05:30,2023-11-17,S88311015,UPI/368715646136/183228/UPI/971167234646axl/UP,NA
DEBIT,UPI,130.0,30070.80,2023-11-18T04:15:54+05:30,2023-11-18,C18121869,UPI/368815660973/020226/UPI/paytmqr1ags36xguwp,NA
DEBIT,UPI,300.0,29770.80,2023-11-18T19:06:10+05:30,2023-11-18,S29564105,UPI/368899592559/190609/UPI/mohitkingguptaokhd,NA
CREDIT,OTHERS,600.0,30370.80,2023-11-19T06:28:19+05:30,2023-11-19,S39158700,NEFT-AXNPN33235789141-PHONEPE PRIVATE LIMITED-PAYM,922020004688715
DEBIT,UPI,1.0,30369.80,2023-11-19T17:26:07+05:30,2023-11-19,S63372745,UPI/332331816385/172607/UPI/9580869402paytm/UP,NA
DEBIT,UPI,499.0,29870.80,2023-11-19T17:37:36+05:30,2023-11-19,S63815747,UPI/368921245431/173736/UPI/9580869402paytm/NA,NA
DEBIT,UPI,20.0,29850.80,2023-11-19T21:50:49+05:30,2023-11-19,S73810569,UPI/332340234812/215048/UPI/pal370093okhdfcban,NA
CREDIT,OTHERS,1700.0,31550.80,2023-11-20T03:59:19+05:30,2023-11-20,S76133698,NEFT-AXNPN33249383441-PHONEPE PRIVATE LIMITED-PAYM,922020004688715
DEBIT,UPI,200.0,31350.80,2023-11-20T19:00:31+05:30,2023-11-20,S7026640,UPI/332490170398/190030/UPI/mohitkingguptaoksb,NA
DEBIT,UPI,45.0,31305.80,2023-11-20T21:15:17+05:30,2023-11-20,S13455325,UPI/332471072950/211516/UPI/gpay-11220941784ok,NA
CREDIT,OTHERS,2200.0,33505.80,2023-11-21T06:58:21+05:30,2023-11-21,S17695392,NEFT-AXNPN33254474828-PHONEPE PRIVATE LIMITED-PAYM,922020004688715
CREDIT,OTHERS,1250.0,34755.80,2023-11-22T06:42:02+05:30,2023-11-22,S57260013,NEFT-AXNPN33267548354-PHONEPE PRIVATE LIMITED-PAYM,922020004688715
DEBIT,UPI,200.0,34555.80,2023-11-22T18:39:18+05:30,2023-11-22,S85716659,UPI/369260045911/183917/UPI/mohitkingguptaokhd,NA
DEBIT,UPI,290.0,34265.80,2023-11-22T21:57:37+05:30,2023-11-22,S94626613,UPI/332672563746/215736/UPI/9794155540ybl/UPI,NA
CREDIT,OTHERS,350.0,34615.80,2023-11-23T06:18:51+05:30,2023-11-23,S97062301,NEFT-AXNPN33271645925-PHONEPE PRIVATE LIMITED-PAYM,922020004688715
CREDIT,UPI,100.0,34715.80,2023-11-23T21:42:33+05:30,2023-11-23,S34926797,UPI/332796236369/214233/UPI/anupamshakya2807-1,NA
CREDIT,UPI,100.0,34815.80,2023-11-23T21:46:28+05:30,2023-11-23,S35037098,UPI/369365682733/214629/UPI/sainiharsh8737891,NA
CREDIT,OTHERS,1600.0,36415.80,2023-11-24T07:14:17+05:30,2023-11-24,S37932261,NEFT-AXNPN33285739683-PHONEPE PRIVATE LIMITED-PAYM,922020004688715
DEBIT,UPI,10.0,36405.80,2023-11-24T14:59:28+05:30,2023-11-24,S55851212,UPI/369477813257/145928/UPI/q425025650ybl/UPI,NA
DEBIT,UPI,201.0,36204.80,2023-11-24T16:08:39+05:30,2023-11-24,S58710202,UPI/369417844707/160839/UPI/JIOINAPPDIRECTybl/,NA
DEBIT,UPI,60.0,36144.80,2023-11-24T21:28:26+05:30,2023-11-24,S75110456,UPI/332879033888/212825/UPI/mosoyamalamicici/U,NA
CREDIT,OTHERS,2200.0,38344.80,2023-11-25T08:30:37+05:30,2023-11-25,S79872993,NEFT-AXNPN33290184240-PHONEPE PRIVATE LIMITED-PAYM,922020004688715
DEBIT,UPI,241.0,38103.80,2023-11-25T08:53:20+05:30,2023-11-25,S80758556,UPI/369522180170/085319/UPI/AIRTELPREDIRECT1yb,NA
DEBIT,UPI,200.0,37903.80,2023-11-25T19:05:45+05:30,2023-11-25,S7437668,UPI/332936175325/190544/UPI/mohitkingguptaoksb,NA
CREDIT,OTHERS,1070.0,38973.80,2023-11-26T06:21:47+05:30,2023-11-26,S16647664,NEFT-AXNPN33303815768-PHONEPE PRIVATE LIMITED-PAYM,922020004688715
DEBIT,UPI,1.0,38972.80,2023-11-26T12:20:28+05:30,2023-11-26,S25779481,UPI/333081087192/122027/UPI/971167234646axl/UP,NA
DEBIT,UPI,5000.0,33972.80,2023-11-26T12:23:45+05:30,2023-11-26,S25916146,UPI/369632489827/122344/UPI/971167234646axl/UP,NA
CREDIT,OTHERS,950.0,34922.80,2023-11-27T05:43:45+05:30,2023-11-27,S50831450,NEFT-AXNPN33317453486-PHONEPE PRIVATE LIMITED-PAYM,922020004688715
DEBIT,UPI,120.0,34802.80,2023-11-27T11:41:51+05:30,2023-11-27,S58990564,UPI/369784123240/114151/UPI/q296232377ybl/UPI,NA
DEBIT,UPI,19.0,34783.80,2023-11-27T23:52:45+05:30,2023-11-27,S86690232,UPI/369719406688/235245/UPI/JIOINAPPDIRECTybl/,NA
CREDIT,OTHERS,800.0,35583.80,2023-11-28T06:25:14+05:30,2023-11-28,S87890619,NEFT-AXNPN33321994185-PHONEPE PRIVATE LIMITED-PAYM,922020004688715
CREDIT,UPI,100.0,35683.80,2023-11-28T13:02:05+05:30,2023-11-28,S754367,UPI/369811008163/130205/UPI/9119906554ybl/Paym,NA
DEBIT,UPI,150.0,35533.80,2023-11-28T19:38:03+05:30,2023-11-28,S21077177,UPI/369895169536/193802/UPI/7275922808ybl/UPI,NA
DEBIT,UPI,19.0,35514.80,2023-11-28T22:19:55+05:30,2023-11-28,S27517857,UPI/333244579400/221954/UPI/euronetgpayrchici,NA
CREDIT,OTHERS,151.0,35665.80,2023-11-29T06:16:57+05:30,2023-11-29,S29481392,NEFT-AXNPN33336248163-PHONEPE PRIVATE LIMITED-PAYM,922020004688715
DEBIT,UPI,40.0,35625.80,2023-11-29T12:21:14+05:30,2023-11-29,S39768545,UPI/333311600550/122114/UPI/paytm-79496683payt,NA
DEBIT,UPI,19000.0,16625.80,2023-11-29T16:15:33+05:30,2023-11-29,S50294642,UPI/333335900423/161532/UPI/mrking25icici/UPI,NA
DEBIT,UPI,12700.0,3925.80,2023-11-29T17:09:47+05:30,2023-11-29,S52850056,UPI/369921004440/170947/UPI/9310460780ibl/UPI,NA
DEBIT,UPI,100.0,3825.80,2023-11-29T18:53:11+05:30,2023-11-29,S58374521,UPI/333315307946/185311/UPI/somendrapratap1616-,NA
DEBIT,UPI,1.0,3824.80,2023-11-29T19:04:54+05:30,2023-11-29,S59014995,UPI/369905915394/190454/UPI/8795417446ybl/UPI,NA
DEBIT,UPI,1.0,3823.80,2023-11-29T19:15:03+05:30,2023-11-29,S59588190,UPI/369916672169/191503/UPI/8795417446ybl/Paym,NA
CREDIT,UPI,2000.0,5823.80,2023-11-29T19:15:25+05:30,2023-11-29,S59609658,UPI/369910143175/191526/UPI/8795417446ybl/Paym,NA
DEBIT,UPI,90.0,5733.80,2023-11-29T20:00:56+05:30,2023-11-29,S62025695,UPI/333360512941/200056/UPI/paytmqrzffdf7kfifp,NA
CREDIT,OTHERS,1500.0,7233.80,2023-12-01T08:37:06+05:30,2023-12-01,C27079184,NEFT-AXNPN33354387161-PHONEPE PRIVATE LIMITED-PAYM,922020004688715
DEBIT,UPI,40.0,7193.80,2023-12-01T17:48:18+05:30,2023-12-01,S38987729,UPI/333570902684/174817/UPI/q936188905ybl/UPI,NA
DEBIT,UPI,199.0,6994.80,2023-12-01T18:39:14+05:30,2023-12-01,S42364769,UPI/333502903016/183913/UPI/billdeskrechargei,NA
DEBIT,UPI,250.0,6744.80,2023-12-01T21:59:01+05:30,2023-12-01,S53075868,UPI/333547819865/215900/UPI/9794155540ybl/UPI,NA
CREDIT,OTHERS,600.0,7344.80,2023-12-02T06:40:09+05:30,2023-12-02,S55898046,NEFT-AXNPN33368654568-PHONEPE PRIVATE LIMITED-PAYM,922020004688715
DEBIT,UPI,500.0,6844.80,2023-12-02T15:54:24+05:30,2023-12-02,S79840370,UPI/370292291528/155423/UPI/9455566771ibl/Paym,NA
DEBIT,UPI,40.0,6804.80,2023-12-02T22:01:38+05:30,2023-12-02,S99439460,UPI/333696772184/220138/UPI/q936188905ybl/UPI,NA
CREDIT,OTHERS,1450.0,8254.80,2023-12-03T11:45:16+05:30,2023-12-03,S11085311,NEFT-AXNPN33373186693-PHONEPE PRIVATE LIMITED-PAYM,922020004688715
DEBIT,UPI,1000.0,7254.80,2023-12-03T14:02:06+05:30,2023-12-03,S17065065,UPI/370367943509/140205/UPI/9455566771ibl/Paym,NA
CREDIT,OTHERS,900.0,8154.80,2023-12-04T05:01:01+05:30,2023-12-04,S40320421,NEFT-AXNPN33387264701-PHONEPE PRIVATE LIMITED-PAYM,922020004688715
DEBIT,UPI,239.0,7915.80,2023-12-04T13:19:24+05:30,2023-12-04,S56854138,UPI/370434730875/131924/UPI/billdeskrechargei,NA
DEBIT,UPI,1550.0,6365.80,2023-12-04T18:05:44+05:30,2023-12-04,S71167958,UPI/370448548188/180544/UPI/vimaltivari7874oks,NA
CREDIT,OTHERS,7560.0,13925.80,2023-12-05T07:08:30+05:30,2023-12-05,S85798345,NEFT-AXNPN33391170193-PHONEPE PRIVATE LIMITED-PAYM,922020004688715
DEBIT,UPI,60.0,13865.80,2023-12-05T11:03:34+05:30,2023-12-05,S94215022,UPI/333992771315/110333/UPI/paytm-64670120payt,NA
DEBIT,UPI,13000.0,865.80,2023-12-05T15:50:06+05:30,2023-12-05,S8245037,UPI/333950785257/155006/UPI/bharatpe9006616689,NA
DEBIT,UPI,200.0,665.80,2023-12-05T23:14:29+05:30,2023-12-05,S28868292,UPI/333957307491/231428/UPI/q507904675ybl/UPI,NA
DEBIT,UPI,138.0,527.80,2023-12-06T22:50:22+05:30,2023-12-06,S73428649,UPI/370631069797/225021/UPI/q507904675ybl/UPI,NA
CREDIT,UPI,150.0,677.80,2023-12-07T10:23:24+05:30,2023-12-07,S80482921,UPI/370786267324/102324/UPI/7860606760ibl/Paym,NA
DEBIT,UPI,18.0,659.80,2023-12-07T21:50:04+05:30,2023-12-07,S15241089,UPI/334168717940/215003/UPI/q335760453ybl/UPI,NA
DEBIT,UPI,70.0,589.80,2023-12-07T22:07:21+05:30,2023-12-07,S15747533,UPI/370712119608/220720/UPI/q964443672ybl/UPI,NA
CREDIT,OTHERS,1630.0,2219.80,2023-12-08T06:03:54+05:30,2023-12-08,S17896665,NEFT-AXNPN33424653823-PHONEPE PRIVATE LIMITED-PAYM,922020004688715
DEBIT,UPI,40.0,2179.80,2023-12-08T10:25:11+05:30,2023-12-08,S24488413,UPI/370803428559/102511/UPI/gpay-11217094612ok,NA
DEBIT,UPI,35.0,2144.80,2023-12-08T22:12:01+05:30,2023-12-08,S61952388,UPI/370882359642/221201/UPI/paytmqr1ny3qn38lnp,NA
CREDIT,OTHERS,210.0,2354.80,2023-12-09T06:39:54+05:30,2023-12-09,S63742607,NEFT-AXNPN33439210579-PHONEPE PRIVATE LIMITED-PAYM,922020004688715
DEBIT,UPI,120.0,2234.80,2023-12-09T12:24:30+05:30,2023-12-09,S75452507,UPI/370905274145/122430/UPI/q289654467ybl/UPI,NA
DEBIT,UPI,40.0,2194.80,2023-12-09T22:09:46+05:30,2023-12-09,S3955340,UPI/334308908589/220945/UPI/q480037413ybl/UPI,NA
CREDIT,OTHERS,450.0,2644.80,2023-12-10T05:33:23+05:30,2023-12-10,S6367672,NEFT-AXNPN33443412565-PHONEPE PRIVATE LIMITED-PAYM,922020004688715
DEBIT,UPI,10.0,2634.80,2023-12-10T21:24:06+05:30,2023-12-10,S39118940,UPI/371079371595/212405/UPI/7860606760ibl/Paym,NA
DEBIT,UPI,5.0,2629.80,2023-12-10T22:11:14+05:30,2023-12-10,S40366614,UPI/371012036515/221114/UPI/shoaibmansooriyoyo-,NA
CREDIT,OTHERS,2300.0,4929.80,2023-12-11T07:09:02+05:30,2023-12-11,S42569667,NEFT-AXNPN33457550249-PHONEPE PRIVATE LIMITED-PAYM,922020004688715
DEBIT,UPI,30.0,4899.80,2023-12-11T22:04:19+05:30,2023-12-11,S85171309,UPI/334585401097/220419/UPI/q832137855ybl/UPI,NA
CREDIT,OTHERS,400.0,5299.80,2023-12-12T09:50:35+05:30,2023-12-12,S92455377,NEFT-AXNPN33461895162-PHONEPE PRIVATE LIMITED-PAYM,922020004688715
DEBIT,UPI,239.0,5060.80,2023-12-12T14:45:43+05:30,2023-12-12,S7306397,UPI/334615011275/144543/UPI/billdeskrechargei,NA
CREDIT,OTHERS,2150.0,7210.80,2023-12-13T07:46:51+05:30,2023-12-13,S32418137,NEFT-AXNPN33476737709-PHONEPE PRIVATE LIMITED-PAYM,922020004688715
DEBIT,UPI,55.0,7155.80,2023-12-13T10:29:35+05:30,2023-12-13,S38274715,UPI/371337156385/102935/UPI/q936188905ybl/UPI,NA
DEBIT,UPI,300.0,6855.80,2023-12-13T16:56:42+05:30,2023-12-13,S57340776,UPI/334724475084/165642/UPI/bharatpe9005948825,NA
DEBIT,UPI,195.0,6660.80,2023-12-13T21:09:37+05:30,2023-12-13,S71409041,UPI/371368889985/210937/UPI/shoaibmansooriyoyo,NA
CREDIT,OTHERS,550.0,7210.80,2023-12-14T07:41:17+05:30,2023-12-14,S76649445,NEFT-AXNPN33481108384-PHONEPE PRIVATE LIMITED-PAYM,922020004688715
DEBIT,UPI,10.0,7200.80,2023-12-14T10:47:17+05:30,2023-12-14,S84316708,UPI/334813799056/104716/UPI/q514575473ybl/UPI,NA
DEBIT,UPI,2000.0,5200.80,2023-12-14T17:25:19+05:30,2023-12-14,S3071234,UPI/371443124777/172518/UPI/shamsukhan88580-1o,NA
DEBIT,UPI,30.0,5170.80,2023-12-15T10:37:43+05:30,2023-12-15,S27147262,UPI/371571155720/103742/UPI/q329690445ybl/UPI,NA
CREDIT,OTHERS,700.0,5870.80,2023-12-16T07:49:37+05:30,2023-12-16,S63954496,NEFT-AXNPN33509669133-PHONEPE PRIVATE LIMITED-PAYM,922020004688715
DEBIT,UPI,30.0,5840.80,2023-12-16T12:27:35+05:30,2023-12-16,S74530352,UPI/371683611974/122735/UPI/gpay-11208826927ok,NA
DEBIT,UPI,500.0,5340.80,2023-12-16T19:12:46+05:30,2023-12-16,S94836379,UPI/335029426653/191246/UPI/mohitkingguptaoksb,NA
CREDIT,OTHERS,1100.0,6440.80,2023-12-17T07:54:58+05:30,2023-12-17,S6337649,NEFT-AXNPN33513397481-PHONEPE PRIVATE LIMITED-PAYM,922020004688715
CREDIT,UPI,500.0,6940.80,2023-12-17T10:31:15+05:30,2023-12-17,S11072292,UPI/335186799080/103116/UPI/shivangdwivedi427o,NA
DEBIT,UPI,120.0,6820.80,2023-12-17T10:34:36+05:30,2023-12-17,S11230543,UPI/371763948785/103436/UPI/q936188905ybl/UPI,NA
DEBIT,UPI,20.0,6800.80,2023-12-17T17:08:49+05:30,2023-12-17,S29767765,UPI/335194173550/170848/UPI/saxenajitender07ok,NA
DEBIT,UPI,30.0,6770.80,2023-12-17T22:13:10+05:30,2023-12-17,S44956745,UPI/371701526426/221310/UPI/7860606760ybl/Paym,NA
CREDIT,OTHERS,1150.0,7920.80,2023-12-18T03:35:02+05:30,2023-12-18,C42691542,NEFT-AXNPN33528038027-PHONEPE PRIVATE LIMITED-PAYM,922020004688715
DEBIT,UPI,1300.0,6620.80,2023-12-18T14:10:53+05:30,2023-12-18,S64613100,UPI/371855202317/141053/UPI/shamsukhan1ybl/UPI,NA
CREDIT,OTHERS,1820.0,8440.80,2023-12-18T19:03:32+05:30,2023-12-18,S79868584,IMPS/P2A/335219855298/PHONEPEPRIVATEL/IMPSAXB9111,NA
DEBIT,UPI,40.0,8400.80,2023-12-19T10:42:35+05:30,2023-12-19,S97481992,UPI/371951549252/104235/UPI/paytmqrihdoh922agp,NA
DEBIT,UPI,500.0,7900.80,2023-12-19T18:38:36+05:30,2023-12-19,S20789100,UPI/335356768557/183836/UPI/mohitkingguptaoksb,NA
DEBIT,UPI,25.0,7875.80,2023-12-19T21:13:49+05:30,2023-12-19,S28854147,UPI/371959485720/211349/UPI/paytmqr6dtdychd3vp,NA
CREDIT,OTHERS,1100.0,8975.80,2023-12-20T05:29:58+05:30,2023-12-20,S32575219,NEFT-AXNPN33546662187-PHONEPE PRIVATE LIMITED-PAYM,922020004688715
DEBIT,UPI,900.0,8075.80,2023-12-20T15:07:42+05:30,2023-12-20,S52112522,UPI/372080094907/150742/UPI/6387326203ybl/UPI,NA
CREDIT,OTHERS,1175.51,9251.31,2023-12-21T05:13:39+05:30,2023-12-21,S74875704,NEFT-AXNPN33551284935-PHONEPE PRIVATE LIMITED-PAYM,922020004688715
CREDIT,UPI,300.0,9551.31,2023-12-21T15:23:52+05:30,2023-12-21,S95105633,UPI/335528082440/152353/UPI/payoutspaytm/20231,NA
DEBIT,UPI,500.0,9051.31,2023-12-21T19:07:06+05:30,2023-12-21,S6917460,UPI/372104348504/190706/UPI/mohitkingguptaoksb,NA
CREDIT,OTHERS,2440.0,11491.31,2023-12-22T06:07:33+05:30,2023-12-22,S16854396,NEFT-AXNPN33565583691-PHONEPE PRIVATE LIMITED-PAYM,922020004688715
DEBIT,UPI,30.0,11461.31,2023-12-22T19:51:31+05:30,2023-12-22,S51050270,UPI/372278597104/195131/UPI/q935592796ybl/UPI,NA
DEBIT,UPI,25.0,11436.31,2023-12-22T19:57:17+05:30,2023-12-22,S51369368,UPI/372265400375/195717/UPI/q935592796ybl/UPI,NA
CREDIT,OTHERS,2730.0,14166.31,2023-12-23T08:18:27+05:30,2023-12-23,S59932009,NEFT-AXNPN33570013984-PHONEPE PRIVATE LIMITED-PAYM,922020004688715
DEBIT,UPI,240.9,13925.41,2023-12-23T11:57:15+05:30,2023-12-23,S68222735,UPI/335700116123/115715/UPI/euronetgpayrchici,NA
DEBIT,UPI,15.0,13910.41,2023-12-23T12:13:42+05:30,2023-12-23,S68939587,UPI/372373619926/121341/UPI/gpaybillpayrchg2a,NA
CREDIT,OTHERS,800.0,14710.41,2023-12-24T06:08:56+05:30,2023-12-24,S97651543,NEFT-AXNPN33584447789-PHONEPE PRIVATE LIMITED-PAYM,922020004688715
DEBIT,UPI,55.0,14655.41,2023-12-24T10:27:47+05:30,2023-12-24,S2844727,UPI/372496057641/102747/UPI/q936188905ybl/UPI,NA
DEBIT,UPI,3000.0,11655.41,2023-12-24T18:11:58+05:30,2023-12-24,S22736107,UPI/335848274773/181158/UPI/saxenajitender07ok,NA
DEBIT,UPI,500.0,11155.41,2023-12-24T18:45:51+05:30,2023-12-24,S24675117,UPI/335863872184/184551/UPI/mohitkingguptaoksb,NA
DEBIT,UPI,500.0,10655.41,2023-12-24T19:31:40+05:30,2023-12-24,S27150470,UPI/372404972339/193140/UPI/shivampandit199999,NA
DEBIT,UPI,100.0,10555.41,2023-12-24T21:29:53+05:30,2023-12-24,S31967810,UPI/335830087206/212953/UPI/bharatpe90725406876,NA
DEBIT,UPI,1000.0,9555.41,2023-12-25T11:14:05+05:30,2023-12-25,S41901541,UPI/372560809534/111405/UPI/9793543675axl/UPI,NA
CREDIT,UPI,700.0,10255.41,2023-12-25T12:12:22+05:30,2023-12-25,S44382704,UPI/335973197398/121223/UPI/shivangdwivedi427o,NA
CREDIT,UPI,1.0,10256.41,2023-12-25T13:04:24+05:30,2023-12-25,S46704648,UPI/335925943300/130425/UPI/goog-paymentokaxis,NA
DEBIT,UPI,2400.0,7856.41,2023-12-25T20:21:17+05:30,2023-12-25,S66362771,UPI/335940420583/202116/UPI/7376946640icici/UP,NA
DEBIT,UPI,2520.0,5336.41,2023-12-25T20:45:46+05:30,2023-12-25,S67383204,UPI/372526813165/204545/UPI/q880116575ybl/UPI,NA
CREDIT,OTHERS,850.0,6186.41,2023-12-26T06:54:12+05:30,2023-12-26,S72046285,NEFT-AXNPN33602337168-PHONEPE PRIVATE LIMITED-PAYM,922020004688715
CREDIT,OTHERS,200.0,6386.41,2023-12-27T05:09:47+05:30,2023-12-27,C51250872,NEFT-AXNPN33616881110-PHONEPE PRIVATE LIMITED-PAYM,922020004688715
DEBIT,UPI,240.9,6145.51,2023-12-27T15:30:42+05:30,2023-12-27,S34755767,UPI/336181979022/153041/UPI/euronetgpayrchici,NA
DEBIT,UPI,5000.0,1145.51,2023-12-27T15:39:10+05:30,2023-12-27,S35131879,UPI/336104091768/153910/UPI/saxenajitender07ok,NA
DEBIT,UPI,500.0,645.51,2023-12-27T18:49:55+05:30,2023-12-27,S44940945,UPI/372733297191/184954/UPI/mohitkingguptaoksb,NA
DEBIT,UPI,500.0,145.51,2023-12-27T18:55:23+05:30,2023-12-27,S45269418,UPI/336133795570/185523/UPI/8795417446ybl/UPI,NA
DEBIT,UPI,15.0,130.51,2023-12-27T21:55:29+05:30,2023-12-27,S53892740,UPI/372733820293/215529/UPI/7860606760ybl/Paym,NA
CREDIT,OTHERS,228.0,358.51,2023-12-28T04:55:22+05:30,2023-12-28,C52477671,NEFT-AXNPN33621080639-PHONEPE PRIVATE LIMITED-PAYM,922020004688715
DEBIT,UPI,20.0,338.51,2023-12-28T22:12:41+05:30,2023-12-28,S98282187,UPI/372822688843/221240/UPI/7860606760ybl/Paym,NA
CREDIT,OTHERS,550.0,888.51,2023-12-29T06:00:15+05:30,2023-12-29,S99871885,NEFT-AXNPN33635402991-PHONEPE PRIVATE LIMITED-PAYM,922020004688715
DEBIT,UPI,10.0,878.51,2023-12-29T20:35:44+05:30,2023-12-29,S35656051,UPI/372930190454/203544/UPI/7860606760ybl/Paym,NA
DEBIT,UPI,500.0,378.51,2023-12-30T18:25:07+05:30,2023-12-30,S70177348,UPI/336476727068/182506/UPI/mohitkingguptaoksb,NA
DEBIT,UPI,78.0,300.51,2023-12-30T21:51:53+05:30,2023-12-30,S80172139,UPI/373061926906/215153/UPI/7860606760ybl/Paym,NA
CREDIT,OTHERS,1059.0,1359.51,2023-12-31T08:21:10+05:30,2023-12-31,C55479130,NEFT-AXNPN33654400751-PHONEPE PRIVATE LIMITED-PAYM,922020004688715
CREDIT,UPI,700.0,2059.51,2023-12-31T16:41:01+05:30,2023-12-31,S3106234,UPI/373135141185/164102/UPI/6386923805ibl/Paym,NA
CREDIT,OTHERS,250.0,2309.51,2024-01-01T03:54:55+05:30,2024-01-01,S22044780,NEFT-AXNPN40018693141-PHONEPE PRIVATE LIMITED-PAYM,922020004688715
CREDIT,UPI,5000.0,7309.51,2024-01-01T18:37:59+05:30,2024-01-01,S54353112,UPI/436734007951/183800/UPI/9910619719ibl/Paym,NA
CREDIT,OTHERS,900.0,8209.51,2024-01-01T18:40:22+05:30,2024-01-01,S54489585,IMPS/P2A/400118123422/PHONEPEPRIVATEL/IMPSAXB9111,NA
DEBIT,UPI,1720.0,6489.51,2024-01-01T19:53:46+05:30,2024-01-01,S58849645,UPI/436779823204/195345/UPI/q880116575ybl/UPI,NA
CREDIT,UPI,120.0,6609.51,2024-01-01T19:54:34+05:30,2024-01-01,S58892581,UPI/400130671636/195435/UPI/rk5282872oksbi/UPI,NA
DEBIT,UPI,3375.0,3234.51,2024-01-01T20:06:06+05:30,2024-01-01,S59542582,UPI/436724717557/200606/UPI/8787297888axl/UPI,NA
DEBIT,UPI,500.0,2734.51,2024-01-02T18:34:13+05:30,2024-01-02,S1858975,UPI/436863651808/183412/UPI/mohitkingguptaokhd,NA
DEBIT,UPI,60.0,2674.51,2024-01-02T19:57:49+05:30,2024-01-02,S7111681,UPI/436837271647/195749/UPI/q935592796ybl/UPI,NA
DEBIT,UPI,250.0,2424.51,2024-01-02T21:04:45+05:30,2024-01-02,S10520468,UPI/436856768415/210445/UPI/q936188905ybl/UPI,NA
CREDIT,OTHERS,70.0,2494.51,2024-01-03T06:24:58+05:30,2024-01-03,C61050184,NEFT-AXNPN40037669598-PHONEPE PRIVATE LIMITED-PAYM,922020004688715
DEBIT,UPI,20.0,2474.51,2024-01-03T20:43:57+05:30,2024-01-03,S55541407,UPI/436994109824/204357/UPI/q716267772ybl/UPI,NA
CREDIT,OTHERS,600.0,3074.51,2024-01-04T05:55:55+05:30,2024-01-04,S60603109,NEFT-AXNPN40042250767-PHONEPE PRIVATE LIMITED-PAYM,922020004688715
DEBIT,UPI,1500.0,1574.51,2024-01-04T18:29:40+05:30,2024-01-04,S92574305,UPI/437000740083/182939/UPI/bharatpe9006231703,NA
DEBIT,UPI,241.0,1333.51,2024-01-04T19:59:28+05:30,2024-01-04,S98131690,UPI/437013084601/195928/UPI/JIOINAPPDIRECTybl/,NA
CREDIT,OTHERS,550.0,1883.51,2024-01-06T06:21:32+05:30,2024-01-06,S51757447,NEFT-AXNPN40061458299-PHONEPE PRIVATE LIMITED-PAYM,922020004688715
DEBIT,UPI,1500.0,383.51,2024-01-06T14:07:33+05:30,2024-01-06,S68666256,UPI/437240122351/140733/UPI/8299743442paytm/UP,NA
CREDIT,OTHERS,2100.0,2483.51,2024-01-08T04:11:11+05:30,2024-01-08,S38544589,NEFT-AXNPN40080707738-PHONEPE PRIVATE LIMITED-PAYM,922020004688715
DEBIT,UPI,500.0,1983.51,2024-01-08T13:10:34+05:30,2024-01-08,S53866288,UPI/437478314150/131033/UPI/goldykashyap1992ok,NA
DEBIT,UPI,500.0,1483.51,2024-01-08T18:48:50+05:30,2024-01-08,S72731366,UPI/400843626406/184849/UPI/mohitkingguptaokax,NA
DEBIT,UPI,200.0,1283.51,2024-01-08T21:55:11+05:30,2024-01-08,S82825777,UPI/400864443405/215511/UPI/shivampandit199999,NA
DEBIT,UPI,240.9,1042.61,2024-01-09T14:48:22+05:30,2024-01-09,S4353360,UPI/400964365351/144822/UPI/euronetgpayrchici,NA
DEBIT,UPI,15.0,1027.61,2024-01-09T19:07:56+05:30,2024-01-09,S18684460,UPI/437518177340/190756/UPI/gpaybillpayrchg2a,NA
DEBIT,UPI,300.0,727.61,2024-01-09T19:25:49+05:30,2024-01-09,S19810043,UPI/437539270785/192548/UPI/gpay-11227240434ok,NA
CREDIT,OTHERS,790.0,1517.61,2024-01-10T05:21:07+05:30,2024-01-10,S30176504,NEFT-AXNPN40100149349-PHONEPE PRIVATE LIMITED-PAYM,922020004688715
DEBIT,UPI,500.0,1017.61,2024-01-10T19:04:49+05:30,2024-01-10,S67007312,UPI/401014519166/190449/UPI/mohitkingguptaoksb,NA
DEBIT,UPI,140.0,877.61,2024-01-10T20:22:52+05:30,2024-01-10,S72142003,UPI/401085033267/202251/UPI/q935592796ybl/UPI,NA
CREDIT,UPI,1.0,878.61,2024-01-10T21:01:34+05:30,2024-01-10,S74236791,UPI/437669522726/210134/UPI/9451168065ybl/Paym,NA
CREDIT,UPI,1999.0,2877.61,2024-01-10T21:06:24+05:30,2024-01-10,S74475100,UPI/437612889834/210625/UPI/9451168065ybl/Paym,NA
DEBIT,UPI,1000.0,1877.61,2024-01-11T14:34:37+05:30,2024-01-11,S98208092,UPI/437756563312/143436/UPI/saxenajitender07ok,NA
CREDIT,OTHERS,470.0,2347.61,2024-01-12T04:37:24+05:30,2024-01-12,S24494436,NEFT-AXNPN40129380265-PHONEPE PRIVATE LIMITED-PAYM,922020004688715
DEBIT,UPI,110.0,2237.61,2024-01-12T10:29:19+05:30,2024-01-12,S31002290,UPI/437870398717/102918/UPI/q936188905ybl/UPI,NA
CREDIT,OTHERS,690.0,2927.61,2024-01-12T18:18:12+05:30,2024-01-12,S57461308,IMPS/P2A/401218945872/PHONEPEPRIVATEL/IMPSAXB9111,NA
DEBIT,UPI,220.0,2707.61,2024-01-12T21:32:52+05:30,2024-01-12,S69086670,UPI/401237433415/213252/UPI/q507904675ybl/UPI,NA
DEBIT,UPI,500.0,2207.61,2024-01-13T18:45:23+05:30,2024-01-13,S5157933,UPI/437912962573/184520/UPI/mohitkingguptaoksb,NA
DEBIT,UPI,350.0,1857.61,2024-01-13T19:33:41+05:30,2024-01-13,S8174520,UPI/401328579453/193339/UPI/paytm-71838008payt,NA
DEBIT,UPI,100.0,1757.61,2024-01-13T19:38:59+05:30,2024-01-13,S8500485,UPI/401359480420/193858/UPI/q750803548ybl/UPI,NA
CREDIT,OTHERS,290.0,2047.61,2024-01-14T06:39:15+05:30,2024-01-14,S17557289,NEFT-AXNPN40148769252-PHONEPE PRIVATE LIMITED-PAYM,922020004688715
DEBIT,UPI,15.0,2032.61,2024-01-14T21:21:31+05:30,2024-01-14,S53186686,UPI/438054916697/212131/UPI/billdeskrechargei,NA
DEBIT,UPI,110.0,1922.61,2024-01-15T11:18:03+05:30,2024-01-15,S65262787,UPI/438172623880/111802/UPI/q936188905ybl/UPI,NA
DEBIT,UPI,80.0,1842.61,2024-01-15T19:45:32+05:30,2024-01-15,S91151837,UPI/438116451940/194532/UPI/q503192015ybl/UPI,NA
CREDIT,OTHERS,1500.0,3342.61,2024-01-16T05:07:02+05:30,2024-01-16,S99372901,NEFT-AXNPN40167082884-PHONEPE PRIVATE LIMITED-PAYM,922020004688715
DEBIT,UPI,10.0,3332.61,2024-01-16T19:10:49+05:30,2024-01-16,S31325951,UPI/438247893470/191048/UPI/q861339801ybl/UPI,NA
CREDIT,UPI,150.0,3482.61,2024-01-16T21:35:13+05:30,2024-01-16,S38717963,UPI/401682428368/213514/UPI/amaankhanfbd1ybl/P,NA
DEBIT,UPI,10.0,3472.61,2024-01-17T11:51:02+05:30,2024-01-17,S51624165,UPI/438399108560/115102/UPI/gpay-11220387437ok,NA
DEBIT,UPI,10.0,3462.61,2024-01-17T20:20:55+05:30,2024-01-17,S78203620,UPI/438317864727/202055/UPI/7860606760ybl/Paym,NA
DEBIT,UPI,300.0,3162.61,2024-01-18T18:49:59+05:30,2024-01-18,S16339465,UPI/438460673818/184958/UPI/mohitkingguptaoksb,NA
DEBIT,UPI,15.0,3147.61,2024-01-18T19:51:29+05:30,2024-01-18,S19970657,UPI/401836984584/195129/UPI/gpaybillpayrchrgo,NA
DEBIT,UPI,240.9,2906.71,2024-01-19T11:59:03+05:30,2024-01-19,S38157480,UPI/438527404958/115902/UPI/euronetgpayrchici,NA
DEBIT,UPI,500.0,2406.71,2024-01-19T16:40:07+05:30,2024-01-19,S51531767,UPI/438575279094/164006/UPI/meenabanti9381ibl/,NA
DEBIT,UPI,155.0,2251.71,2024-01-19T20:31:13+05:30,2024-01-19,S64775227,UPI/438568020964/203112/UPI/ptsameertiwarioksb,NA
CREDIT,OTHERS,90.0,2341.71,2024-01-20T05:18:36+05:30,2024-01-20,S70936878,NEFT-AXNPN40205732267-PHONEPE PRIVATE LIMITED-PAYM,922020004688715
CREDIT,OTHERS,580.0,2921.71,2024-01-21T06:02:52+05:30,2024-01-21,S15213055,NEFT-AXNPN40210525110-PHONEPE PRIVATE LIMITED-PAYM,922020004688715
DEBIT,UPI,300.0,2621.71,2024-01-21T19:06:36+05:30,2024-01-21,S43740992,UPI/438764410634/190636/UPI/mohitkingguptaoksb,NA
DEBIT,UPI,50.0,2571.71,2024-01-21T19:34:28+05:30,2024-01-21,S45316378,UPI/402102817981/193427/UPI/paytmqr168mbo7u8up,NA
DEBIT,UPI,10.0,2561.71,2024-01-22T13:46:05+05:30,2024-01-22,S68374672,UPI/402204140913/134604/UPI/rlsrls611okaxis/UP,NA
CREDIT,OTHERS,350.0,2911.71,2024-01-24T04:34:42+05:30,2024-01-24,S33211036,NEFT-AXNPN40242398567-PHONEPE PRIVATE LIMITED-PAYM,922020004688715
DEBIT,UPI,240.9,2670.81,2024-01-24T17:47:55+05:30,2024-01-24,S60427511,UPI/402445024965/174754/UPI/gpaybillpayrchrgo,NA
DEBIT,UPI,500.0,2170.81,2024-01-24T18:42:09+05:30,2024-01-24,S63675166,UPI/402463511768/184209/UPI/mohitkingguptaoksb,NA
CREDIT,OTHERS,300.0,2470.81,2024-01-26T05:16:51+05:30,2024-01-26,S19351993,NEFT-AXNPN40260945206-PHONEPE PRIVATE LIMITED-PAYM,922020004688715
DEBIT,UPI,260.0,2210.81,2024-01-26T19:20:40+05:30,2024-01-26,S49792691,UPI/439231012421/192040/UPI/9794155540-2ybl/UP,NA
CREDIT,OTHERS,550.0,2760.81,2024-01-27T04:18:22+05:30,2024-01-27,S58852979,NEFT-AXNPN40275270663-PHONEPE PRIVATE LIMITED-PAYM,922020004688715
DEBIT,UPI,120.0,2640.81,2024-01-27T10:40:05+05:30,2024-01-27,S64911289,UPI/439337530490/104005/UPI/q936188905ybl/UPI,NA
DEBIT,UPI,500.0,2140.81,2024-01-27T18:58:28+05:30,2024-01-27,S87911468,UPI/402787347044/185827/UPI/mohitkingguptaoksb,NA
DEBIT,UPI,35.0,2105.81,2024-01-27T20:20:33+05:30,2024-01-27,S92353250,UPI/402792564133/202032/UPI/q467757807ybl/UPI,NA
CREDIT,OTHERS,1720.0,3825.81,2024-01-28T04:16:50+05:30,2024-01-28,S98235638,NEFT-AXNPN40289411150-PHONEPE PRIVATE LIMITED-PAYM,922020004688715
DEBIT,UPI,15.0,3810.81,2024-01-28T13:58:21+05:30,2024-01-28,S12240984,UPI/439477969974/135821/UPI/billdeskrechargei,NA
DEBIT,UPI,800.0,3010.81,2024-01-28T14:37:28+05:30,2024-01-28,S13761771,UPI/439417473158/143727/UPI/saxenajitender07ok,NA
DEBIT,UPI,50.0,2960.81,2024-01-28T20:02:17+05:30,2024-01-28,S28770350,UPI/402845097455/200216/UPI/bharatpe90725406876,NA
CREDIT,OTHERS,1850.0,4810.81,2024-01-29T04:36:54+05:30,2024-01-29,S34806216,NEFT-AXNPN40293250185-PHONEPE PRIVATE LIMITED-PAYM,922020004688715
CREDIT,UPI,100.0,4910.81,2024-01-29T21:07:49+05:30,2024-01-29,S74448876,UPI/402951045257/210749/UPI/shivampandit199999,NA
CREDIT,OTHERS,800.0,5710.81,2024-01-30T06:36:50+05:30,2024-01-30,S79776273,NEFT-AXNPN40307831851-PHONEPE PRIVATE LIMITED-PAYM,922020004688715
DEBIT,UPI,80.0,5630.81,2024-01-30T10:44:32+05:30,2024-01-30,S86243142,UPI/403001042078/104432/UPI/1850593898688amair,NA
DEBIT,UPI,7.0,5623.81,2024-01-30T15:13:21+05:30,2024-01-30,S98958198,UPI/439677560297/151321/UPI/bharatpe9006872372,NA
DEBIT,UPI,500.0,5123.81,2024-01-30T19:07:51+05:30,2024-01-30,S10972971,UPI/403085677146/190750/UPI/mohitkingguptaoksb,NA
CREDIT,OTHERS,207.0,5330.81,2024-01-31T05:15:11+05:30,2024-01-31,S22028058,NEFT-AXNPN40312286488-PHONEPE PRIVATE LIMITED-PAYM,922020004688715
DEBIT,UPI,5000.0,330.81,2024-01-31T14:55:18+05:30,2024-01-31,S42040506,UPI/439726896337/145517/UPI/saxenajitender07ok,NA
CREDIT,UPI,100.0,430.81,2024-01-31T19:17:57+05:30,2024-01-31,S56435699,UPI/439702920595/191758/UPI/shivampandit199999,NA
DEBIT,UPI,100.0,330.81,2024-01-31T19:58:20+05:30,2024-01-31,S58920801,UPI/439755826335/195819/UPI/q987204052ybl/UPI,NA
CREDIT,OTHERS,900.0,1230.81,2024-02-01T05:28:38+05:30,2024-02-01,C85094376,NEFT-AXNPN40326715012-PHONEPE PRIVATE LIMITED-PAYM,922020004688715
DEBIT,UPI,19.0,1211.81,2024-02-01T18:31:37+05:30,2024-02-01,S3354,UPI/439816951393/183136/UPI/euronetgpayrchici,NA
CREDIT,OTHERS,58.0,1269.81,2024-02-03T09:29:49+05:30,2024-01-31,S68777922,51888100006461IntPd01-11-2023 to 31-01-2024,NA
CREDIT,UPI,200.0,1469.81,2024-02-03T18:53:39+05:30,2024-02-03,S98007158,UPI/403447957327/185339/UPI/ksonu433477okicici,NA
DEBIT,UPI,400.0,1069.81,2024-02-03T19:58:44+05:30,2024-02-03,S2384693,UPI/403462557497/195844/UPI/bharatpe9006655445,NA
DEBIT,UPI,50.0,1019.81,2024-02-03T21:01:22+05:30,2024-02-03,S6035339,UPI/440068369860/210121/UPI/bharatpe90725406876,NA
DEBIT,UPI,120.0,899.81,2024-02-03T21:04:22+05:30,2024-02-03,S6161442,UPI/403408367825/210421/UPI/nooralamkhan98788o,NA
CREDIT,OTHERS,800.0,1699.81,2024-02-04T06:58:51+05:30,2024-02-04,S12312613,NEFT-AXNPN40351071566-PHONEPE PRIVATE LIMITED-PAYM,922020004688715
DEBIT,UPI,120.0,1579.81,2024-02-04T19:50:17+05:30,2024-02-04,S45105126,UPI/403530713901/195016/UPI/q507904675ybl/UPI,NA
DEBIT,UPI,50.0,1529.81,2024-02-05T12:32:51+05:30,2024-02-05,S67493037,UPI/440243828100/123251/UPI/dubeyadharvoksbi/U,NA
DEBIT,UPI,500.0,1029.81,2024-02-05T18:21:15+05:30,2024-02-05,S86955164,UPI/440228943474/182114/UPI/dubeyadharvoksbi/U,NA
DEBIT,UPI,150.0,879.81,2024-02-05T18:41:54+05:30,2024-02-05,S88349487,UPI/440252941887/184154/UPI/bharatpe9006231703,NA
DEBIT,UPI,10.0,869.81,2024-02-06T11:15:11+05:30,2024-02-06,S12120402,UPI/403796983076/111511/UPI/q514575473ybl/UPI,NA
DEBIT,UPI,200.0,669.81,2024-02-07T19:10:09+05:30,2024-02-07,S79622135,UPI/440492869984/191008/UPI/mohitkingguptaoksb,NA
DEBIT,UPI,10.0,659.81,2024-02-07T21:22:08+05:30,2024-02-07,S88026719,UPI/440452465926/212207/UPI/7860606760ybl/Paym,NA
CREDIT,OTHERS,2600.0,3259.81,2024-02-08T07:59:15+05:30,2024-02-08,S93362653,NEFT-AXNPN40390150217-PHONEPE PRIVATE LIMITED-PAYM,922020004688715
DEBIT,UPI,50.0,3209.81,2024-02-08T13:35:09+05:30,2024-02-08,S9026611,UPI/403979207531/133508/UPI/saxenajitender07ok,NA
DEBIT,UPI,120.0,3089.81,2024-02-08T14:25:59+05:30,2024-02-08,S11871596,UPI/440517798961/142558/UPI/paytmqraysb0m9zgnp,NA
DEBIT,UPI,240.0,2849.81,2024-02-08T20:34:42+05:30,2024-02-08,S33226438,UPI/403910909971/203442/UPI/arvindsingh7860000,NA
DEBIT,UPI,100.0,2749.81,2024-02-09T15:58:47+05:30,2024-02-09,S64099319,UPI/440657956965/155846/UPI/9653029504paytm/UP,NA
CREDIT,OTHERS,750.0,3499.81,2024-02-10T06:47:12+05:30,2024-02-10,S87919218,NEFT-AXNPN40419484619-PHONEPE PRIVATE LIMITED-PAYM,922020004688715
DEBIT,UPI,500.0,2999.81,2024-02-10T19:05:57+05:30,2024-02-10,S23557384,UPI/404141429592/190556/UPI/mohitkingguptaokhd,NA
DEBIT,UPI,15.0,2984.81,2024-02-11T14:56:13+05:30,2024-02-11,S56914409,UPI/440809262354/145612/UPI/gpaybillpayrchrgo,NA
DEBIT,UPI,30.0,2954.81,2024-02-11T20:16:14+05:30,2024-02-11,S74119209,UPI/404235679280/201614/UPI/q290444500ybl/UPI,NA
CREDIT,UPI,200.0,3154.81,2024-02-11T21:40:10+05:30,2024-02-11,S77665834,UPI/404269427688/214010/UPI/shivampandit199999,NA
CREDIT,OTHERS,590.0,3744.81,2024-02-12T04:46:01+05:30,2024-02-12,S80634012,NEFT-AXNPN40438685742-PHONEPE PRIVATE LIMITED-PAYM,922020004688715
CREDIT,UPI,10000.0,13744.81,2024-02-12T13:22:57+05:30,2024-02-12,S97183279,UPI/440961634787/132257/UPI/8795417446ybl/Paym,NA
DEBIT,UPI,500.0,13244.81,2024-02-12T14:46:04+05:30,2024-02-12,S1680810,UPI/404373716225/144604/UPI/q420727784ybl/UPI,NA
DEBIT,ATM,10000.0,3244.81,2024-02-13T14:01:51+05:30,2024-02-13,S47446558,ATM/CASH/404414021517/XXXXXXXXXXXX8896,NA
DEBIT,UPI,300.0,2944.81,2024-02-13T19:05:07+05:30,2024-02-13,S63775576,UPI/404482571739/190506/UPI/mohitkingguptaoksb,NA
DEBIT,UPI,40.0,2904.81,2024-02-13T21:10:58+05:30,2024-02-13,S71468342,UPI/441032984621/211058/UPI/ssumitpal922okhdfc,NA
DEBIT,UPI,30.0,2874.81,2024-02-13T21:48:30+05:30,2024-02-13,S73053582,UPI/441087766377/214829/UPI/7860606760ybl/Paym,NA
CREDIT,OTHERS,50.0,2924.81,2024-02-14T06:10:23+05:30,2024-02-14,S76096806,NEFT-AXNPN40457808985-PHONEPE PRIVATE LIMITED-PAYM,922020004688715
DEBIT,UPI,1.0,2923.81,2024-02-14T13:20:34+05:30,2024-02-14,S92114600,UPI/404533698195/132034/UPI/rahulguptanaokaxis,NA
DEBIT,UPI,2544.0,379.81,2024-02-14T13:26:07+05:30,2024-02-14,S92423475,UPI/441151112210/132607/UPI/rahulguptanaokaxis,NA
DEBIT,UPI,100.0,279.81,2024-02-14T13:41:48+05:30,2024-02-14,S93270227,UPI/441121212205/134147/UPI/nitinmishra9697oks,NA
DEBIT,UPI,60.0,219.81,2024-02-14T17:59:43+05:30,2024-02-14,S6503238,UPI/441129511856/175943/UPI/q987204052ybl/UPI,NA
CREDIT,UPI,4.0,223.81,2024-02-15T19:59:25+05:30,2024-02-15,S60856000,UPI/404658902080/195925/UPI/dubeyadharvoksbi/U,NA
CREDIT,UPI,3000.0,3223.81,2024-02-15T20:47:28+05:30,2024-02-15,S63704459,UPI/441279546319/204729/UPI/8318914152ybl/Paym,NA
DEBIT,UPI,40.0,3183.81,2024-02-16T10:16:08+05:30,2024-02-16,S75902865,UPI/404721790029/101607/UPI/q936188905ybl/UPI,NA
DEBIT,UPI,15.0,3168.81,2024-02-16T15:56:04+05:30,2024-02-16,S92870985,UPI/441343605988/155603/UPI/euronetgpayrchici,NA
DEBIT,UPI,180.0,2988.81,2024-02-16T22:59:08+05:30,2024-02-16,S14240599,UPI/441341736027/225907/UPI/q507904675ybl/UPI,NA
DEBIT,UPI,240.9,2747.91,2024-02-17T11:25:20+05:30,2024-02-17,S24710034,UPI/441422640164/112519/UPI/gpaybillpayrchrgo,NA
DEBIT,UPI,2500.0,247.91,2024-02-17T15:33:27+05:30,2024-02-17,S37469230,UPI/404847053335/153326/UPI/shivampandit199999,NA
CREDIT,OTHERS,440.0,687.91,2024-02-18T04:47:29+05:30,2024-02-18,S60446661,NEFT-AXNPN40492895372-PHONEPE PRIVATE LIMITED-PAYM,922020004688715
DEBIT,UPI,80.0,607.91,2024-02-19T10:40:59+05:30,2024-02-19,S9810004,UPI/441607649919/104059/UPI/q936188905ybl/UPI,NA
CREDIT,UPI,40.0,647.91,2024-02-19T13:01:03+05:30,2024-02-19,S16590914,UPI/405016448388/130104/UPI/mayankbhai73590oki,NA
DEBIT,UPI,40.0,607.91,2024-02-19T17:02:08+05:30,2024-02-19,S27840432,UPI/405019765039/170207/UPI/mayankbhai73590oki,NA
DEBIT,UPI,10.0,597.91,2024-02-19T21:16:52+05:30,2024-02-19,S42417738,UPI/441618378621/211651/UPI/bharatpe9006990474,NA
CREDIT,UPI,100.0,697.91,2024-02-20T12:50:40+05:30,2024-02-20,S61232645,UPI/441761496027/125040/UPI/9910619719ybl/Paym,NA
DEBIT,UPI,290.0,407.91,2024-02-20T12:57:12+05:30,2024-02-20,S61562960,UPI/405148097069/125712/UPI/paytm-71838008payt,NA
DEBIT,UPI,130.0,277.91,2024-02-21T19:14:06+05:30,2024-02-21,S27565599,UPI/441878461042/191405/UPI/gpay-11224839269ok,NA
CREDIT,OTHERS,3600.0,3877.91,2024-02-22T06:08:44+05:30,2024-02-22,S39785070,NEFT-AXNPN40533478873-PHONEPE PRIVATE LIMITED-PAYM,922020004688715
DEBIT,UPI,40.0,3837.91,2024-02-22T18:17:40+05:30,2024-02-22,S70408981,UPI/441943998479/181739/UPI/q895367275ybl/UPI,NA
DEBIT,UPI,25.0,3812.91,2024-02-22T18:58:23+05:30,2024-02-22,S72913044,UPI/405316304018/185822/UPI/paytmqr6n3frf9lelp,NA
DEBIT,UPI,15.0,3797.91,2024-02-22T20:28:24+05:30,2024-02-22,S78592652,UPI/405350926936/202823/UPI/gpaybillpayrchrgo,NA
DEBIT,UPI,19.0,3778.91,2024-02-22T21:00:43+05:30,2024-02-22,S80269936,UPI/405388828676/210042/UPI/euronetgpayrchici,NA
DEBIT,UPI,200.0,3578.91,2024-02-23T19:32:01+05:30,2024-02-23,S20044225,UPI/405438755332/193200/UPI/dubeyadharvoksbi/U,NA
DEBIT,UPI,20.0,3558.91,2024-02-23T19:40:21+05:30,2024-02-23,S20575016,UPI/405466063656/194020/UPI/bharatpe9006937899,NA
DEBIT,UPI,40.0,3518.91,2024-02-23T20:30:40+05:30,2024-02-23,S23611105,UPI/405462561088/203040/UPI/paytmqr281005050101,NA
DEBIT,UPI,35.0,3483.91,2024-02-24T16:38:47+05:30,2024-02-24,S50201204,UPI/405526002597/163846/UPI/q387867621ybl/UPI,NA
CREDIT,UPI,20000.0,23483.91,2024-02-24T18:55:15+05:30,2024-02-24,S58360773,UPI/442192582411/185516/UPI/8795417446-2ybl/Pa,NA
CREDIT,UPI,200.0,23683.91,2024-02-24T19:26:25+05:30,2024-02-24,S60379495,UPI/405522192936/192626/UPI/dubeyadharvoksbi/U,NA
DEBIT,UPI,20000.0,3683.91,2024-02-25T11:08:34+05:30,2024-02-25,S77431539,UPI/405633427538/110833/UPI/8318914152axl/UPI,NA
CREDIT,UPI,100.0,3783.91,2024-02-25T14:22:06+05:30,2024-02-25,S86084276,UPI/405647910397/142207/UPI/dubeyadharvoksbi/U,NA
DEBIT,UPI,100.0,3683.91,2024-02-25T14:54:23+05:30,2024-02-25,S87391602,UPI/442248946671/145423/UPI/q901958227ybl/UPI,NA
DEBIT,UPI,19.0,3664.91,2024-02-25T19:34:09+05:30,2024-02-25,S1258236,UPI/442288761022/193408/UPI/euronetgpayrchici,NA
CREDIT,UPI,20000.0,23664.91,2024-02-25T20:08:58+05:30,2024-02-25,S3167582,UPI/442272156503/200859/UPI/8318914152ybl/Paym,NA
DEBIT,UPI,60.0,23604.91,2024-02-26T11:52:47+05:30,2024-02-26,S20311418,UPI/442393088932/115247/UPI/q936188905ybl/UPI,NA
DEBIT,UPI,10.0,23594.91,2024-02-27T21:23:00+05:30,2024-02-27,S94752597,UPI/442431067517/212300/UPI/bharatpe9006990474,NA
CREDIT,UPI,100.0,23694.91,2024-02-28T12:55:41+05:30,2024-02-28,S12999270,UPI/405977407689/125541/UPI/dubeyadharvoksbi/U,NA
CREDIT,UPI,50.0,23744.91,2024-02-28T15:27:02+05:30,2024-02-28,S20313075,UPI/442551593707/152703/UPI/9910619719ybl/Paym,NA
DEBIT,UPI,140.0,23604.91,2024-02-28T15:30:35+05:30,2024-02-28,S20469007,UPI/442544790040/153034/UPI/paytm-71838008payt,NA
DEBIT,UPI,500.0,23104.91,2024-02-29T10:33:53+05:30,2024-02-29,S60251772,UPI/406028538169/103352/UPI/q794239763ybl/UPI,NA
DEBIT,UPI,200.0,22904.91,2024-02-29T11:13:11+05:30,2024-02-29,S62581566,UPI/442681525335/111310/UPI/rrolex593-1okicici,NA
DEBIT,UPI,500.0,22404.91,2024-03-01T10:52:36+05:30,2024-03-01,S10080876,UPI/442725876691/105235/UPI/q181032143ybl/UPI,NA
DEBIT,UPI,50.0,22354.91,2024-03-01T16:12:05+05:30,2024-03-01,S27766189,UPI/406188200128/161205/UPI/8299505517-2ybl/UP,NA
DEBIT,UPI,10.0,22344.91,2024-03-02T16:28:12+05:30,2024-03-02,S80974527,UPI/442832658736/162812/UPI/q742616359ybl/UPI,NA
DEBIT,UPI,10.0,22334.91,2024-03-02T21:15:27+05:30,2024-03-02,S98382672,UPI/442855974244/211527/UPI/bharatpe9006990474,NA
DEBIT,UPI,95.0,22239.91,2024-03-03T09:58:26+05:30,2024-03-03,S10771861,UPI/406308282156/095825/UPI/q189410455ybl/UPI,NA
DEBIT,UPI,40.0,22199.91,2024-03-03T11:19:44+05:30,2024-03-03,S14845060,UPI/406344087793/111944/UPI/gpay-11240173941ok,NA
DEBIT,UPI,55.0,22144.91,2024-03-03T12:06:28+05:30,2024-03-03,S17344782,UPI/406331797775/120627/UPI/q936188905ybl/UPI,NA
DEBIT,UPI,10.0,22134.91,2024-03-03T15:27:59+05:30,2024-03-03,S28421444,UPI/442921699463/152758/UPI/q087828198ybl/UPI,NA
DEBIT,UPI,80.0,22054.91,2024-03-03T17:17:14+05:30,2024-03-03,S33858159,UPI/406339505154/171713/UPI/bharatpe90725406876,NA
CREDIT,UPI,200.0,22254.91,2024-03-03T17:23:16+05:30,2024-03-03,S34186970,UPI/442927378643/172316/UPI/9140092527ybl/Paym,NA
DEBIT,UPI,18.0,22236.91,2024-03-03T19:35:19+05:30,2024-03-03,S42160607,UPI/406354729546/193518/UPI/q290444500ybl/UPI,NA
DEBIT,UPI,130.0,22106.91,2024-03-03T19:37:48+05:30,2024-03-03,S42315682,UPI/406369919499/193747/UPI/gpay-11224839269ok,NA
DEBIT,UPI,20.0,22086.91,2024-03-04T10:34:28+05:30,2024-03-04,S58841099,UPI/443089338388/103427/UPI/q491609826ybl/UPI,NA
CREDIT,UPI,100.0,22186.91,2024-03-04T14:03:39+05:30,2024-03-04,S70591540,UPI/406404593963/140340/UPI/dubeyadharvoksbi/U,NA
CREDIT,UPI,100.0,22286.91,2024-03-04T14:05:28+05:30,2024-03-04,S70686903,UPI/406404667972/140529/UPI/dubeyadharvoksbi/U,NA
DEBIT,UPI,55.0,22231.91,2024-03-04T14:08:28+05:30,2024-03-04,S70847578,UPI/443063534969/140828/UPI/q936188905ybl/UPI,NA
DEBIT,UPI,30.0,22201.91,2024-03-04T14:12:06+05:30,2024-03-04,S71043944,UPI/443013849882/141206/UPI/im201027500377ind,NA
DEBIT,UPI,60.0,22141.91,2024-03-04T14:24:28+05:30,2024-03-04,S71689124,UPI/443049844095/142428/UPI/q882371871ybl/UPI,NA
DEBIT,UPI,10.0,22131.91,2024-03-04T14:51:41+05:30,2024-03-04,S73031609,UPI/443007955265/145140/UPI/paytmqr15wmuj8wjwp,NA
DEBIT,UPI,10.0,22121.91,2024-03-04T17:35:12+05:30,2024-03-04,S81476265,UPI/443046854329/173511/UPI/q257474859ybl/UPI,NA
DEBIT,UPI,240.9,21881.01,2024-03-05T17:44:53+05:30,2024-03-05,S33821656,UPI/443110207039/174452/UPI/gpaybillpayrchrgo,NA
DEBIT,UPI,60.0,21821.01,2024-03-06T09:35:49+05:30,2024-03-06,S56989035,UPI/406644847193/093548/UPI/q031954753ybl/UPI,NA
DEBIT,UPI,420.0,21401.01,2024-03-06T12:30:36+05:30,2024-03-06,S66682858,UPI/443250562116/123035/UPI/q420727784ybl/UPI,NA
CREDIT,UPI,100.0,21501.01,2024-03-06T15:23:46+05:30,2024-03-06,S77002648,UPI/443283731179/152347/UPI/sirajmohd23ibl/Pa,NA
CREDIT,UPI,100.0,21601.01,2024-03-06T15:25:31+05:30,2024-03-06,S77082670,UPI/443231436454/152531/UPI/sirajmohd23axl/Pa,NA
DEBIT,UPI,140.0,21461.01,2024-03-06T15:58:13+05:30,2024-03-06,S78701681,UPI/443257270146/155812/UPI/paytm-71838008payt,NA
CREDIT,UPI,100.0,21561.01,2024-03-06T17:12:08+05:30,2024-03-06,S82610329,UPI/443253653663/171208/UPI/9910619719ibl/Paym,NA
DEBIT,UPI,4600.0,16961.01,2024-03-07T17:19:46+05:30,2024-03-07,S33071786,UPI/406756424114/171945/UPI/simplemanishokaxis,NA
DEBIT,UPI,22.0,16939.01,2024-03-08T15:26:02+05:30,2024-03-08,S78518483,UPI/443468695377/152602/UPI/bharatpe9006990474,NA
DEBIT,UPI,10.0,16929.01,2024-03-08T20:18:24+05:30,2024-03-08,S94027419,UPI/443449096939/201823/UPI/bharatpe9006990474,NA
DEBIT,UPI,85.0,16844.01,2024-03-08T21:40:50+05:30,2024-03-08,S97833648,UPI/443404993928/214049/UPI/q016242371ybl/UPI,NA
DEBIT,UPI,180.0,16664.01,2024-03-08T21:42:47+05:30,2024-03-08,S97899194,UPI/406801602946/214246/UPI/paytmqr1ij9iz6aavp,NA
DEBIT,UPI,290.0,16374.01,2024-03-09T12:57:12+05:30,2024-03-09,S15234635,UPI/443516917898/125711/UPI/q482222842ybl/UPI,NA
DEBIT,UPI,500.0,15874.01,2024-03-09T19:16:11+05:30,2024-03-09,S35158114,UPI/406965446547/191610/UPI/mohitkingguptaoksb,NA
DEBIT,UPI,520.0,15354.01,2024-03-10T13:03:56+05:30,2024-03-10,S63359370,UPI/443628673546/130356/UPI/paytmqr1s35rk2e0mp,NA
DEBIT,UPI,15.0,15339.01,2024-03-10T21:10:14+05:30,2024-03-10,S88594107,UPI/407097512033/211014/UPI/gpaybillpayrchrgo,NA
DEBIT,UPI,200.0,15139.01,2024-03-11T19:13:57+05:30,2024-03-11,S32274624,UPI/407143240314/191356/UPI/pamit1566oksbi/UPI,NA
CREDIT,OTHERS,1630.0,16769.01,2024-03-12T08:16:35+05:30,2024-03-12,S48224862,NEFT-AXNPN07236221944-PHONEPE PRIVATE LIMITED-PAYM,922020004688715
CREDIT,OTHERS,140.0,16909.01,2024-03-13T06:01:19+05:30,2024-03-13,S95541334,NEFT-AXNPN07346182027-PHONEPE PRIVATE LIMITED-PAYM,922020004688715
DEBIT,UPI,59.0,16850.01,2024-03-13T19:08:04+05:30,2024-03-13,S31793270,UPI/443997054139/190803/UPI/q750803548ybl/UPI,NA
DEBIT,UPI,15.0,16835.01,2024-03-13T21:33:52+05:30,2024-03-13,S40846095,UPI/407385966499/213352/UPI/bharatpe9006990474,NA
DEBIT,UPI,5000.0,11835.01,2024-03-14T13:13:55+05:30,2024-03-14,S62504503,UPI/407407288470/131354/UPI/saxenajitender07ok,NA
DEBIT,UPI,500.0,11335.01,2024-03-14T19:09:23+05:30,2024-03-14,S82322099,UPI/444059804493/190922/UPI/mohitkingguptaokhd,NA
CREDIT,UPI,200.0,11535.01,2024-03-14T19:22:06+05:30,2024-03-14,S83265720,UPI/444045776225/192206/UPI/9119906554-2ybl/Pa,NA
DEBIT,UPI,15.0,11520.01,2024-03-14T19:27:57+05:30,2024-03-14,S83665891,UPI/407401904634/192757/UPI/gpaybillpayrchrgo,NA
DEBIT,UPI,126.0,11394.01,2024-03-14T19:37:42+05:30,2024-03-14,S84335027,UPI/407498107006/193742/UPI/bharatpe9006745441,NA
CREDIT,OTHERS,300.0,11694.01,2024-03-15T05:36:40+05:30,2024-03-15,S96129046,NEFT-AXNPN07565943484-PHONEPE PRIVATE LIMITED-PAYM,922020004688715
DEBIT,UPI,10.0,11684.01,2024-03-15T12:43:46+05:30,2024-03-15,S11778956,UPI/444164830072/124346/UPI/q087828198ybl/UPI,NA
DEBIT,UPI,10.0,11674.01,2024-03-15T15:12:17+05:30,2024-03-15,S19700251,UPI/407549542305/151217/UPI/q290444500ybl/UPI,NA
DEBIT,UPI,60.0,11614.01,2024-03-15T20:33:33+05:30,2024-03-15,S39211975,UPI/444123552727/203332/UPI/q005868899ybl/UPI,NA
DEBIT,UPI,20.0,11594.01,2024-03-15T20:54:59+05:30,2024-03-15,S40491335,UPI/444111063232/205458/UPI/6394329180paytm/UP,NA
CREDIT,OTHERS,800.0,12394.01,2024-03-16T06:12:03+05:30,2024-03-16,S47437259,NEFT-AXNPN07675649505-PHONEPE PRIVATE LIMITED-PAYM,922020004688715
DEBIT,UPI,240.9,12153.11,2024-03-16T10:49:26+05:30,2024-03-16,S55651618,UPI/444278876627/104925/UPI/gpaybillpayrchrgo,NA
CREDIT,OTHERS,2150.0,14303.11,2024-03-17T06:59:24+05:30,2024-03-17,S99224797,NEFT-AXNPN07785291996-PHONEPE PRIVATE LIMITED-PAYM,922020004688715
DEBIT,UPI,300.0,14003.11,2024-03-17T15:24:36+05:30,2024-03-17,S19023190,UPI/407704051233/152435/UPI/saxenajitender07ok,NA
DEBIT,UPI,19.0,13984.11,2024-03-17T18:49:10+05:30,2024-03-17,S30843170,UPI/407743853060/184910/UPI/gpaybillpayrchrgo,NA
CREDIT,OTHERS,250.0,14234.11,2024-03-18T06:07:14+05:30,2024-03-18,S43939934,NEFT-AXNPN07894176291-PHONEPE PRIVATE LIMITED-PAYM,922020004688715
DEBIT,UPI,10.0,14224.11,2024-03-18T13:36:35+05:30,2024-03-18,S60722438,UPI/407889589156/133635/UPI/8957278788axl/UPI,NA
CREDIT,OTHERS,1150.0,15374.11,2024-03-19T05:41:17+05:30,2024-03-19,S92296112,NEFT-AXNPN07903656851-PHONEPE PRIVATE LIMITED-PAYM,922020004688715
DEBIT,UPI,30.0,15344.11,2024-03-19T11:32:29+05:30,2024-03-19,S3206504,UPI/407907632578/113229/UPI/bharatpe9006231703,NA
DEBIT,UPI,15.0,15329.11,2024-03-19T20:43:41+05:30,2024-03-19,S32846113,UPI/444589261166/204340/UPI/q087828198ybl/UPI,NA
DEBIT,UPI,130.0,15199.11,2024-03-19T20:45:22+05:30,2024-03-19,S32939321,UPI/407962159656/204522/UPI/gpay-11224839268ok,NA
DEBIT,UPI,3000.0,12199.11,2024-03-19T21:05:45+05:30,2024-03-19,S33970928,UPI/444529980986/210545/UPI/8860721183paytm/UP,NA
CREDIT,OTHERS,920.0,13119.11,2024-03-20T06:11:27+05:30,2024-03-20,S39910676,NEFT-AXNPN08013228203-PHONEPE PRIVATE LIMITED-PAYM,922020004688715
DEBIT,UPI,12000.0,1119.11,2024-03-20T18:56:48+05:30,2024-03-20,S75496843,UPI/444654608986/185648/UPI/8303922846ibl/UPI,NA
DEBIT,UPI,500.0,619.11,2024-03-20T19:16:10+05:30,2024-03-20,S76808415,UPI/408068311785/191610/UPI/mohitkingguptaoksb,NA
DEBIT,UPI,125.0,494.11,2024-03-20T21:36:49+05:30,2024-03-20,S85083918,UPI/408044119876/213649/UPI/q242127661ybl/UPI,NA
CREDIT,OTHERS,270.0,764.11,2024-03-21T07:36:02+05:30,2024-03-21,S91593187,NEFT-AXNPN08123043186-PHONEPE PRIVATE LIMITED-PAYM,922020004688715
DEBIT,UPI,170.0,594.11,2024-03-21T18:13:10+05:30,2024-03-21,S22068994,UPI/444700347922/181309/UPI/saxenajitender07ok,NA
DEBIT,UPI,5.0,589.11,2024-03-21T20:37:47+05:30,2024-03-21,S31658358,UPI/444726269938/203747/UPI/bharatpe9006428914,NA
CREDIT,OTHERS,1370.0,1959.11,2024-03-22T06:47:33+05:30,2024-03-22,S39285871,NEFT-AXNPN08232507646-PHONEPE PRIVATE LIMITED-PAYM,922020004688715
CREDIT,UPI,3000.0,4959.11,2024-03-22T08:47:52+05:30,2024-03-22,S42508951,UPI/444841401061/084752/UPI/8318914152ybl/Paym,NA
DEBIT,UPI,11.0,4948.11,2024-03-22T09:35:52+05:30,2024-03-22,S45250644,UPI/444862076633/093551/UPI/bharatpe9006990474,NA
DEBIT,UPI,100.0,4848.11,2024-03-22T20:32:49+05:30,2024-03-22,S82857285,UPI/408217206371/203248/UPI/saxenajitender07ok,NA
DEBIT,UPI,4380.0,468.11,2024-03-23T11:24:29+05:30,2024-03-23,S2376163,UPI/444938630091/112429/UPI/amzn0009895929apl/,NA
DEBIT,UPI,130.0,338.11,2024-03-23T21:06:25+05:30,2024-03-23,S35010975,UPI/444914061362/210625/UPI/gpay-11224839268ok,NA
CREDIT,OTHERS,4300.0,4638.11,2024-03-24T05:28:09+05:30,2024-03-24,S40232993,NEFT-AXNPN08451764733-PHONEPE PRIVATE LIMITED-PAYM,922020004688715
DEBIT,UPI,40.0,4598.11,2024-03-24T18:22:46+05:30,2024-03-24,S70617124,UPI/408460115571/182245/UPI/ujjwalgupta77889-2,NA
CREDIT,UPI,1500.0,6098.11,2024-03-24T18:30:50+05:30,2024-03-24,S71113028,UPI/408454786813/183050/UPI/8178328660ybl/Paym,NA
DEBIT,UPI,500.0,5598.11,2024-03-24T19:16:53+05:30,2024-03-24,S74229377,UPI/445051513067/191652/UPI/mohitkingguptaoksb,NA
DEBIT,UPI,200.0,5398.11,2024-03-24T22:58:47+05:30,2024-03-24,S83863740,UPI/408407715731/225846/UPI/q267469252ybl/UPI,NA
DEBIT,UPI,30.0,5368.11,2024-03-25T09:28:55+05:30,2024-03-25,S89747372,UPI/408584234003/092855/UPI/bharatpe9006990474,NA
CREDIT,UPI,100.0,5468.11,2024-03-25T20:38:19+05:30,2024-03-25,S18592040,UPI/445156560833/203820/UPI/8726128640ybl/Paym,NA
DEBIT,UPI,19.0,5449.11,2024-03-25T21:21:27+05:30,2024-03-25,S20185945,UPI/408578152981/212126/UPI/euronetgpayrchici,NA
DEBIT,UPI,120.0,5329.11,2024-03-26T11:01:31+05:30,2024-03-26,S33927128,UPI/408611871441/110131/UPI/q936188905ybl/UPI,NA
DEBIT,UPI,10.0,5319.11,2024-03-27T13:30:49+05:30,2024-03-27,S90109268,UPI/445353822402/133048/UPI/q087828198ybl/UPI,NA
DEBIT,UPI,50.0,5269.11,2024-03-27T17:18:13+05:30,2024-03-27,S1173253,UPI/445336325888/171812/UPI/bharatpe90725406876,NA
DEBIT,UPI,20.0,5249.11,2024-03-27T17:20:10+05:30,2024-03-27,S1285184,UPI/408724934697/172010/UPI/eazypay582087377i,NA
DEBIT,UPI,15.0,5234.11,2024-03-27T21:49:50+05:30,2024-03-27,S17811265,UPI/408760451907/214950/UPI/bharatpe9006990474,NA
DEBIT,UPI,50.0,5184.11,2024-03-28T14:43:48+05:30,2024-03-28,S42056148,UPI/408877073796/144347/UPI/bharatpe9006655445,NA
DEBIT,UPI,10.0,5174.11,2024-03-28T16:00:42+05:30,2024-03-28,S45613960,UPI/408838279674/160041/UPI/bharatpe9006724625,NA
CREDIT,UPI,500.0,5674.11,2024-03-28T17:12:05+05:30,2024-03-28,S49643218,UPI/445447800624/171205/UPI/sajalgupta123ybl/P,NA
DEBIT,UPI,5000.0,674.11,2024-03-28T17:50:04+05:30,2024-03-28,S51865958,UPI/408830181590/175003/UPI/6386098404ibl/UPI,NA
CREDIT,UPI,5000.0,5674.11,2024-03-28T19:45:57+05:30,2024-03-28,S59721674,UPI/445453420833/194558/UPI/6386098404ibl/Paym,NA
DEBIT,UPI,10.0,5664.11,2024-03-28T22:08:14+05:30,2024-03-28,S67281597,UPI/445451509080/220813/UPI/bharatpe9006990474,NA
CREDIT,OTHERS,170.0,5834.11,2024-03-29T08:27:48+05:30,2024-03-29,S72746866,NEFT-AXNPN08993522184-PHONEPE PRIVATE LIMITED-PAYM,922020004688715
DEBIT,UPI,500.0,5334.11,2024-03-29T12:06:25+05:30,2024-03-29,S82235885,UPI/408913322613/120624/UPI/9027218679ybl/UPI,NA
DEBIT,UPI,260.0,5074.11,2024-03-29T12:46:55+05:30,2024-03-29,S84460709,UPI/445520817522/124654/UPI/gpay-11224839269ok,NA
DEBIT,UPI,10.0,5064.11,2024-03-29T17:58:43+05:30,2024-03-29,S99633106,UPI/445531226243/175842/UPI/eazypay582087377i,NA
DEBIT,UPI,10.0,5054.11,2024-03-29T21:47:18+05:30,2024-03-29,S13178062,UPI/445561962383/214718/UPI/bharatpe9006990474,NA
DEBIT,UPI,500.0,4554.11,2024-03-30T19:17:09+05:30,2024-03-30,S54908128,UPI/445622203499/191708/UPI/mohitkingguptaokhd,NA
DEBIT,UPI,50.0,4504.11,2024-03-30T21:04:34+05:30,2024-03-30,S62021373,UPI/445676707123/210434/UPI/bharatpe90725406876,NA
CREDIT,OTHERS,950.0,5454.11,2024-03-31T08:16:16+05:30,2024-03-31,S70801124,NEFT-AXNPN09107889601-PHONEPE PRIVATE LIMITED-PAYM,922020004688715
CREDIT,UPI,20.0,5474.11,2024-03-31T12:15:02+05:30,2024-03-31,S81433189,UPI/409149527852/121502/UPI/bobbyshakya76788486,NA
DEBIT,UPI,1.0,5473.11,2024-03-31T13:21:53+05:30,2024-03-31,S84779839,UPI/445714418195/132153/UPI/918081294317paytm/,NA
DEBIT,UPI,500.0,4973.11,2024-03-31T13:22:24+05:30,2024-03-31,S84805048,UPI/409196329345/132223/UPI/918081294317paytm/,NA
DEBIT,UPI,130.0,4843.11,2024-03-31T20:22:18+05:30,2024-03-31,S7747519,UPI/445739859879/202218/UPI/gpay-11224839268ok,NA
DEBIT,UPI,160.0,4683.11,2024-03-31T23:23:46+05:30,2024-03-31,S14677766,UPI/409121456173/232346/UPI/8957060762ybl/UPI,NA
DEBIT,UPI,10.0,4673.11,2024-04-01T16:16:05+05:30,2024-04-01,C9758854,UPI/445815167210/112540/UPI/paytmqr281005050101,NA
DEBIT,UPI,560.0,4113.11,2024-04-01T16:16:17+05:30,2024-04-01,C9883246,UPI/409266370577/112827/UPI/msbkclothcentereaz,NA
DEBIT,UPI,50.0,4063.11,2024-04-01T16:16:35+05:30,2024-04-01,C12458820,UPI/445842677028/122425/UPI/gpay-11220340584ok,NA
DEBIT,UPI,10.0,4053.11,2024-04-01T16:16:54+05:30,2024-04-01,C16441605,UPI/409251593914/140108/UPI/q290444500ybl/UPI,NA
DEBIT,UPI,500.0,3553.11,2024-04-02T01:38:38+05:30,2024-04-01,C23621574,UPI/445880786188/171634/UPI/sajalgupta123ibl/P,NA
CREDIT,UPI,500.0,4053.11,2024-04-02T01:39:27+05:30,2024-04-01,C27511745,UPI/445816921965/183241/UPI/9580265955ybl/Paym,NA
DEBIT,UPI,500.0,3553.11,2024-04-02T01:39:52+05:30,2024-04-01,C30174030,UPI/409210964427/191614/UPI/mohitkingguptaokhd,NA
CREDIT,OTHERS,100.0,3653.11,2024-04-02T01:41:28+05:30,2024-04-01,C40390756,IMPS/P2A/409223023408/PHONEPEPRIVATEL/IMPSAXB9111,NA
CREDIT,UPI,500.0,4153.11,2024-04-02T15:37:11+05:30,2024-04-02,S31037985,UPI/445622203499/RET/30032024,NA
DEBIT,UPI,240.0,3913.11,2024-04-02T19:19:45+05:30,2024-04-02,S58475707,UPI/409309272566/191944/UPI/saxenajitender07ok,NA
CREDIT,OTHERS,30.0,3943.11,2024-04-03T05:58:21+05:30,2024-04-03,C43023654,NEFT-AXNPN09423821251-PHONEPE PRIVATE LIMITED-PAYM,922020004688715
DEBIT,UPI,200.0,3743.11,2024-04-04T14:41:56+05:30,2024-04-04,S47889882,UPI/409593564960/144156/UPI/q289654467ybl/UPI,NA
DEBIT,UPI,500.0,3243.11,2024-04-04T19:18:18+05:30,2024-04-04,S63622499,UPI/409549666132/191818/UPI/6393859545axl/UPI,NA
DEBIT,UPI,100.0,3143.11,2024-04-04T20:14:55+05:30,2024-04-04,S67425964,UPI/409551587458/201453/UPI/paytmqrzhod33y3sfp,NA
DEBIT,UPI,120.0,3023.11,2024-04-05T11:39:00+05:30,2024-04-05,S90305353,UPI/409640198457/113859/UPI/paytm-71838008payt,NA
DEBIT,UPI,50.0,2973.11,2024-04-05T12:07:13+05:30,2024-04-05,S91782253,UPI/446203089625/120713/UPI/bharatpe9006655445,NA
DEBIT,UPI,10.0,2963.11,2024-04-05T14:54:28+05:30,2024-04-05,S555275,UPI/409683807147/145428/UPI/q290444500ybl/UPI,NA
DEBIT,UPI,130.0,2833.11,2024-04-05T20:30:24+05:30,2024-04-05,S21214615,UPI/446219927806/203023/UPI/gpay-11223375885ok,NA
CREDIT,OTHERS,280.0,3113.11,2024-04-06T06:19:51+05:30,2024-04-06,S30865923,NEFT-AXNPN09751220727-PHONEPE PRIVATE LIMITED-PAYM,922020004688715
DEBIT,UPI,10.0,3103.11,2024-04-06T16:54:27+05:30,2024-04-06,S60353737,UPI/409772468921/165426/UPI/dheerajpratap6225i,NA
DEBIT,UPI,10.0,3093.11,2024-04-06T17:32:49+05:30,2024-04-06,S62553838,UPI/409764273005/173249/UPI/q290444500ybl/UPI,NA
DEBIT,UPI,50.0,3043.11,2024-04-06T17:55:11+05:30,2024-04-06,S63995245,UPI/409700682948/175510/UPI/shivampandit199999,NA
DEBIT,UPI,130.0,2913.11,2024-04-06T21:30:20+05:30,2024-04-06,S77498568,UPI/409752402357/213019/UPI/gpay-11223375885ok,NA
DEBIT,UPI,160.0,2753.11,2024-04-06T21:42:18+05:30,2024-04-06,S78087401,UPI/446330298360/214218/UPI/gpay-11223375885ok,NA
DEBIT,UPI,10.0,2743.11,2024-04-07T09:02:21+05:30,2024-04-07,S85778762,UPI/446454807547/090220/UPI/bharatpe9006990474,NA
CREDIT,OTHERS,1350.0,4093.11,2024-04-07T09:27:42+05:30,2024-04-07,S86844237,NEFT-AXNPN09860526863-PHONEPE PRIVATE LIMITED-PAYM,922020004688715
DEBIT,UPI,1000.0,3093.11,2024-04-07T14:46:17+05:30,2024-04-07,S1883757,UPI/409823087939/144616/UPI/rrohanthakur142oks,NA
DEBIT,UPI,500.0,2593.11,2024-04-07T19:17:29+05:30,2024-04-07,S16435711,UPI/409862242180/191728/UPI/mohitkingguptaoksb,NA
CREDIT,UPI,500.0,3093.11,2024-04-07T19:52:20+05:30,2024-04-07,S18852528,UPI/409890320950/195220/UPI/mohitkingguptaokax,NA
DEBIT,UPI,130.0,2963.11,2024-04-07T21:05:41+05:30,2024-04-07,S23304330,UPI/409803479607/210541/UPI/gpay-11223375885ok,NA
DEBIT,UPI,240.0,2723.11,2024-04-07T23:05:16+05:30,2024-04-07,S27639872,UPI/446448276124/230516/UPI/Q267469252ybl/Paym,NA
DEBIT,ATM,2500.0,223.11,2024-04-08T10:26:34+05:30,2024-04-08,S37330369,ATM/CASH/409910021816/XXXXXXXXXXXX8896,NA
CREDIT,OTHERS,1320.0,1543.11,2024-04-09T05:14:12+05:30,2024-04-09,S81738385,NEFT-AXNPN10078490209-PHONEPE PRIVATE LIMITED-PAYM,922020004688715
DEBIT,UPI,400.0,1143.11,2024-04-09T11:37:55+05:30,2024-04-09,S93103205,UPI/446616125009/113755/UPI/gpay-11227202961ok,NA
DEBIT,UPI,200.0,943.11,2024-04-09T11:43:33+05:30,2024-04-09,S93399161,UPI/446633615136/114333/UPI/6386098404axl/UPI,NA
DEBIT,UPI,130.0,813.11,2024-04-09T15:07:52+05:30,2024-04-09,S4198698,UPI/410018524682/150751/UPI/saxenajitender07ok,NA
DEBIT,UPI,260.0,553.11,2024-04-09T20:26:50+05:30,2024-04-09,S22731151,UPI/410014341560/202650/UPI/gpay-11227202961ok,NA
DEBIT,UPI,130.0,423.11,2024-04-09T20:45:56+05:30,2024-04-09,S23920914,UPI/410069749896/204556/UPI/gpay-11223375885ok,NA
DEBIT,UPI,16.0,407.11,2024-04-09T21:56:06+05:30,2024-04-09,S27379913,UPI/446689118975/215606/UPI/7860606760ybl/Paym,NA
CREDIT,OTHERS,700.0,1107.11,2024-04-10T05:35:46+05:30,2024-04-10,S31767667,NEFT-AXNPN10187448879-PHONEPE PRIVATE LIMITED-PAYM,922020004688715
DEBIT,UPI,19.0,1088.11,2024-04-10T19:53:48+05:30,2024-04-10,S72917290,UPI/410184305437/195347/UPI/gpaybillpayrchrgo,NA
DEBIT,UPI,130.0,958.11,2024-04-10T21:02:16+05:30,2024-04-10,S77453152,UPI/410160311732/210216/UPI/gpay-11223375885ok,NA
DEBIT,UPI,20.0,938.11,2024-04-10T22:10:29+05:30,2024-04-10,S80940176,UPI/446764231863/221029/UPI/7860606760ybl/Paym,NA
DEBIT,UPI,35.0,903.11,2024-04-10T22:14:35+05:30,2024-04-10,S81088793,UPI/446749698851/221435/UPI/gpay-11242874027ok,NA
CREDIT,OTHERS,230.0,1133.11,2024-04-11T05:53:55+05:30,2024-04-11,S84592585,NEFT-AXNPN10296849616-PHONEPE PRIVATE LIMITED-PAYM,922020004688715
DEBIT,UPI,720.9,412.21,2024-04-11T11:25:46+05:30,2024-04-11,S94971106,UPI/446899222199/112546/UPI/gpaybillpayrchrgo,NA
DEBIT,UPI,130.0,282.21,2024-04-11T16:30:44+05:30,2024-04-11,S9411806,UPI/446828130520/163044/UPI/gpay-11223375885ok,NA
DEBIT,UPI,220.0,62.21,2024-04-11T22:54:14+05:30,2024-04-11,S27960236,UPI/446854367255/225413/UPI/q267469252ybl/UPI,NA
CREDIT,OTHERS,2589.0,2651.21,2024-04-12T04:48:34+05:30,2024-04-12,S29801055,NEFT-AXNPN10304642528-PHONEPE PRIVATE LIMITED-PAYM,922020004688715
DEBIT,UPI,500.0,2151.21,2024-04-12T12:27:05+05:30,2024-04-12,S43804533,UPI/446985974443/122704/UPI/saxenajitender07ok,NA
DEBIT,UPI,450.0,1701.21,2024-04-12T18:30:00+05:30,2024-04-12,S62862119,UPI/410361482958/183000/UPI/9174357502ybl/UPI,NA
CREDIT,UPI,30000.0,31701.21,2024-04-12T20:47:44+05:30,2024-04-12,S72310155,UPI/410362944187/204745/UPI/8960920752ibl/Paym,NA
DEBIT,UPI,30000.0,1701.21,2024-04-12T20:50:06+05:30,2024-04-12,S72445629,UPI/446935401186/205005/UPI/shivampandit199999,NA
CREDIT,OTHERS,800.0,2501.21,2024-04-13T05:13:19+05:30,2024-04-13,S79232613,NEFT-AXNPN10413139173-PHONEPE PRIVATE LIMITED-PAYM,922020004688715
DEBIT,UPI,2350.0,151.21,2024-04-13T14:34:33+05:30,2024-04-13,S99681123,UPI/410433532732/143433/UPI/faizanrangrezz44-1,NA
CREDIT,UPI,1500.0,1651.21,2024-04-13T14:56:52+05:30,2024-04-13,S885413,UPI/447027427446/145653/UPI/80776452910ybl/Pay,NA
DEBIT,UPI,1500.0,151.21,2024-04-14T12:21:12+05:30,2024-04-14,S40587054,UPI/447121872807/122111/UPI/80776452910ybl/Pay,NA
DEBIT,UPI,150.0,1.21,2024-04-14T18:04:34+05:30,2024-04-14,S55533259,UPI/447161793893/180434/UPI/7897780417shivamax,NA
CREDIT,OTHERS,950.0,951.21,2024-04-15T04:58:30+05:30,2024-04-15,S71615337,NEFT-AXNPN10629944424-PHONEPE PRIVATE LIMITED-PAYM,922020004688715
DEBIT,UPI,10.0,941.21,2024-04-15T16:45:22+05:30,2024-04-15,S743330,UPI/447241413638/164522/UPI/8795417446-2ybl/Pa,NA
DEBIT,UPI,50.0,891.21,2024-04-15T18:21:54+05:30,2024-04-15,S6422299,UPI/410669436051/182153/UPI/hbaghel8361axl/UPI,NA
DEBIT,UPI,200.0,691.21,2024-04-15T19:12:24+05:30,2024-04-15,S10051115,UPI/447283339404/191221/UPI/mohitkingguptaoksb,NA
DEBIT,UPI,15.0,676.21,2024-04-15T19:35:54+05:30,2024-04-15,S11631471,UPI/447284839771/193554/UPI/gpaybillpayrchrgo,NA
DEBIT,UPI,130.0,546.21,2024-04-15T20:22:08+05:30,2024-04-15,S14850204,UPI/447207338548/202207/UPI/gpay-11223375885ok,NA
CREDIT,OTHERS,600.0,1146.21,2024-04-16T06:14:43+05:30,2024-04-16,S24410841,NEFT-AXNPN10738834356-PHONEPE PRIVATE LIMITED-PAYM,922020004688715
DEBIT,UPI,130.0,1016.21,2024-04-16T12:02:51+05:30,2024-04-16,S37502036,UPI/410781169121/120251/UPI/gpay-11223375885ok,NA
CREDIT,OTHERS,3420.0,4436.21,2024-04-17T05:15:50+05:30,2024-04-17,S74198025,NEFT-AXNPN10847845753-PHONEPE PRIVATE LIMITED-PAYM,922020004688715
DEBIT,UPI,100.0,4336.21,2024-04-17T17:35:46+05:30,2024-04-17,S2630817,UPI/447413927991/173545/UPI/q548472529ybl/UPI,NA
DEBIT,UPI,130.0,4206.21,2024-04-17T17:40:36+05:30,2024-04-17,S2870270,UPI/410819831990/174035/UPI/q197781220ybl/UPI,NA
DEBIT,UPI,4000.0,206.21,2024-04-17T19:16:12+05:30,2024-04-17,S8608503,UPI/410800330107/191612/UPI/115127996041847cnr,NA
DEBIT,UPI,40.0,166.21,2024-04-17T20:39:39+05:30,2024-04-17,S13723990,UPI/410846742590/203938/UPI/paytmqrse44upsf18p,NA
DEBIT,UPI,130.0,36.21,2024-04-18T13:09:44+05:30,2024-04-18,S36821833,UPI/410986065989/130944/UPI/saxenajitender07ok,NA
CREDIT,OTHERS,500.0,536.21,2024-04-19T06:58:16+05:30,2024-04-19,S68990391,NEFT-AXNPN11065444663-PHONEPE PRIVATE LIMITED-PAYM,922020004688715
DEBIT,UPI,400.0,136.21,2024-04-19T19:35:04+05:30,2024-04-19,S3586681,UPI/447679238301/193503/UPI/vishalkumar9807-2o,NA
DEBIT,UPI,20.0,116.21,2024-04-19T20:23:27+05:30,2024-04-19,S6605046,UPI/447639724190/202327/UPI/q290444500ybl/UPI,NA
DEBIT,UPI,10.0,106.21,2024-04-19T22:43:03+05:30,2024-04-19,S12745228,UPI/447695543572/224303/UPI/7860606760ybl/Paym,NA
CREDIT,OTHERS,1450.0,1556.21,2024-04-20T05:18:47+05:30,2024-04-20,S15076742,NEFT-AXNPN11174599533-PHONEPE PRIVATE LIMITED-PAYM,922020004688715
DEBIT,UPI,130.0,1426.21,2024-04-20T17:53:37+05:30,2024-04-20,S44746006,UPI/447751763220/175337/UPI/gpay-11223375885ok,NA
DEBIT,UPI,200.0,1226.21,2024-04-20T19:35:41+05:30,2024-04-20,S51404809,UPI/447794971795/193540/UPI/mohitkingguptaoksb,NA
DEBIT,UPI,60.0,1166.21,2024-04-20T21:05:02+05:30,2024-04-20,S56849863,UPI/411107084878/210501/UPI/q005868899ybl/UPI,NA
DEBIT,UPI,10.0,1156.21,2024-04-20T21:27:16+05:30,2024-04-20,S57987113,UPI/447712328264/212716/UPI/7860606760ybl/Paym,NA
CREDIT,OTHERS,780.0,1936.21,2024-04-21T05:01:49+05:30,2024-04-21,S62688761,NEFT-AXNPN11283758485-PHONEPE PRIVATE LIMITED-PAYM,922020004688715
CREDIT,OTHERS,2970.0,4906.21,2024-04-22T05:38:05+05:30,2024-04-22,S7516773,NEFT-AXNPN11392698261-PHONEPE PRIVATE LIMITED-PAYM,922020004688715
DEBIT,UPI,130.0,4776.21,2024-04-22T17:26:48+05:30,2024-04-22,S35199129,UPI/411318549861/172647/UPI/gpay-11223375885ok,NA
DEBIT,UPI,380.0,4396.21,2024-04-22T20:49:10+05:30,2024-04-22,S48001604,UPI/411396471510/204909/UPI/bharatpe9006231703,NA
DEBIT,UPI,15.0,4381.21,2024-04-22T22:00:40+05:30,2024-04-22,S51421036,UPI/447946867544/220040/UPI/euronetgpaybillpay,NA
DEBIT,UPI,10.0,4371.21,2024-04-22T22:32:06+05:30,2024-04-22,S52376982,UPI/411348067210/223206/UPI/bharatpe9006990474,NA
CREDIT,OTHERS,300.0,4671.21,2024-04-23T05:40:40+05:30,2024-04-23,S54708429,NEFT-AXNPN11401782717-PHONEPE PRIVATE LIMITED-PAYM,922020004688715
DEBIT,UPI,130.0,4541.21,2024-04-23T15:24:21+05:30,2024-04-23,S76695306,UPI/411424290088/152421/UPI/gpay-11223375885ok,NA
DEBIT,UPI,130.0,4411.21,2024-04-23T15:58:13+05:30,2024-04-23,S78107986,UPI/448085591686/155813/UPI/gpay-11223375885ok,NA
DEBIT,UPI,400.0,4011.21,2024-04-23T19:19:48+05:30,2024-04-23,S89094678,UPI/411469808206/191947/UPI/mohitkingguptaoksb,NA
CREDIT,OTHERS,1570.0,5581.21,2024-04-24T04:44:37+05:30,2024-04-24,S814061,NEFT-AXNPN11510876467-PHONEPE PRIVATE LIMITED-PAYM,922020004688715
DEBIT,UPI,1.0,5580.21,2024-04-24T12:06:43+05:30,2024-04-24,S15160194,UPI/411507716620/120643/UPI/bflautopayhdfcbank,NA
CREDIT,UPI,1.0,5581.21,2024-04-24T12:06:46+05:30,2024-04-24,S15162845,UPI/411507708698/120647/UPI/bflautopayhdfcbank,NA
DEBIT,UPI,130.0,5451.21,2024-04-24T20:44:48+05:30,2024-04-24,S42801729,UPI/448168877269/204448/UPI/gpay-11223375885ok,NA
CREDIT,OTHERS,1200.0,6651.21,2024-04-25T04:51:40+05:30,2024-04-25,S49882177,NEFT-AXNPN11620067677-PHONEPE PRIVATE LIMITED-PAYM,922020004688715
CREDIT,OTHERS,1160.0,7811.21,2024-04-26T06:36:52+05:30,2024-04-26,S96954482,NEFT-AXNPN11729650056-PHONEPE PRIVATE LIMITED-PAYM,922020004688715
DEBIT,UPI,250.0,7561.21,2024-04-26T13:00:17+05:30,2024-04-26,S10891890,UPI/411760596944/130017/UPI/brajeshssingh1984o,NA
DEBIT,UPI,130.0,7431.21,2024-04-26T14:23:24+05:30,2024-04-26,S14338725,UPI/411709455980/142323/UPI/gpay-11223375885ok,NA
DEBIT,UPI,260.0,7171.21,2024-04-26T19:15:39+05:30,2024-04-26,S28494371,UPI/411756073472/191538/UPI/gpay-11223375885ok,NA
CREDIT,OTHERS,1060.0,8231.21,2024-04-27T07:00:33+05:30,2024-04-27,S42334220,NEFT-AXNPN11837826782-PHONEPE PRIVATE LIMITED-PAYM,922020004688715
DEBIT,UPI,1.0,8230.21,2024-04-27T13:05:06+05:30,2024-04-27,S56375721,UPI/411827840950/130505/UPI/amzn0009895929apl/,NA
DEBIT,UPI,7500.0,730.21,2024-04-27T13:08:14+05:30,2024-04-27,S56538216,UPI/411827964797/130814/UPI/amzn0009895929apl/,NA
DEBIT,UPI,12.0,718.21,2024-04-27T14:02:20+05:30,2024-04-27,S58982027,UPI/411837740425/140219/UPI/gpay-11220941784ok,NA
DEBIT,UPI,400.0,318.21,2024-04-27T19:18:46+05:30,2024-04-27,S75837752,UPI/448497723796/191846/UPI/6393859545axl/Paym,NA
CREDIT,OTHERS,1100.0,1418.21,2024-04-28T04:54:15+05:30,2024-04-28,S87706032,NEFT-AXNPN11947635585-PHONEPE PRIVATE LIMITED-PAYM,922020004688715
DEBIT,UPI,50.0,1368.21,2024-04-28T07:55:36+05:30,2024-04-28,S89387914,UPI/448558552515/075536/UPI/Q715088262ybl/Paym,NA
DEBIT,UPI,10.0,1358.21,2024-04-28T13:09:05+05:30,2024-04-28,S1672746,UPI/411962844472/130905/UPI/gpay-11220941784ok,NA
DEBIT,UPI,50.0,1308.21,2024-04-28T18:56:18+05:30,2024-04-28,S16233521,UPI/448549956823/185618/UPI/9580286196ybl/Paym,NA
CREDIT,UPI,1.0,1309.21,2024-04-28T19:23:24+05:30,2024-04-28,S18189272,UPI/448513094529/192324/UPI/rboy32851okicici/U,NA
CREDIT,UPI,499.0,1808.21,2024-04-28T19:24:38+05:30,2024-04-28,S18283978,UPI/411981597069/192438/UPI/rboy32851okhdfcban,NA
DEBIT,UPI,15.0,1793.21,2024-04-28T21:01:49+05:30,2024-04-28,S23909205,UPI/448521649980/210148/UPI/JIOINAPPDIRECT1ybl,NA
CREDIT,OTHERS,650.0,2443.21,2024-04-29T06:13:39+05:30,2024-04-29,S29258524,NEFT-AXNPN12056089599-PHONEPE PRIVATE LIMITED-PAYM,922020004688715
CREDIT,OTHERS,50.0,2493.21,2024-04-30T05:49:04+05:30,2024-04-30,S78292735,NEFT-AXNPN12165089763-PHONEPE PRIVATE LIMITED-PAYM,922020004688715
DEBIT,UPI,70.0,2423.21,2024-04-30T10:04:17+05:30,2024-04-30,S84968858,UPI/448725209818/100416/UPI/Q480037413ybl/Paym,NA
DEBIT,UPI,10.0,2413.21,2024-04-30T10:30:02+05:30,2024-04-30,S86365620,UPI/412136010608/103001/UPI/q826329285ybl/UPI,NA
DEBIT,UPI,15.0,2398.21,2024-04-30T10:33:15+05:30,2024-04-30,S86555499,UPI/412136145946/103314/UPI/q514575473ybl/UPI,NA
DEBIT,UPI,480.0,1918.21,2024-04-30T13:20:14+05:30,2024-04-30,S95189171,UPI/448713092284/132014/UPI/Q420727784ybl/Paym,NA
DEBIT,UPI,1000.0,918.21,2024-04-30T14:11:00+05:30,2024-04-30,S97636774,UPI/448793432790/141059/UPI/6386098404ibl/Paym,NA
DEBIT,UPI,130.0,788.21,2024-04-30T15:56:26+05:30,2024-04-30,S2313323,UPI/412108189289/155626/UPI/gpay-11223375885ok,NA
DEBIT,UPI,600.0,188.21,2024-04-30T19:26:30+05:30,2024-04-30,S14357381,UPI/412158949371/192630/UPI/6393859545ybl/UPI,NA
CREDIT,OTHERS,1650.0,1838.21,2024-05-01T06:23:33+05:30,2024-05-01,S27929948,NEFT-AXNPN12274224174-PHONEPE PRIVATE LIMITED-PAYM,922020004688715
DEBIT,UPI,242.0,1596.21,2024-05-01T07:11:50+05:30,2024-05-01,S28719659,UPI/448895429986/071150/UPI/JIOINAPPDIRECTybl/,NA
CREDIT,OTHERS,47.0,1643.21,2024-05-02T05:25:12+05:30,2024-04-30,S78744785,51888100006461IntPd01-02-2024 to 30-04-2024,NA
CREDIT,OTHERS,860.0,2503.21,2024-05-02T05:49:21+05:30,2024-05-02,S79219411,NEFT-AXNPN12383850372-PHONEPE PRIVATE LIMITED-PAYM,922020004688715
DEBIT,UPI,20.0,2483.21,2024-05-02T11:53:45+05:30,2024-05-02,S93995387,UPI/412323164441/115345/UPI/q818086188ybl/UPI,NA
DEBIT,UPI,10.0,2473.21,2024-05-02T14:27:43+05:30,2024-05-02,S2421537,UPI/412329456333/142742/UPI/q290444500ybl/UPI,NA
DEBIT,UPI,80.0,2393.21,2024-05-02T16:34:02+05:30,2024-05-02,S8454243,UPI/412309466302/163401/UPI/paytmqr1reyim9t8ap,NA
DEBIT,UPI,1500.0,893.21,2024-05-02T17:28:22+05:30,2024-05-02,S11670155,UPI/412336017261/172821/UPI/amzn0009895929apl/,NA
DEBIT,UPI,130.0,763.21,2024-05-02T18:05:15+05:30,2024-05-02,S13865745,UPI/412355574748/180514/UPI/gpay-11223375885ok,NA
DEBIT,UPI,130.0,633.21,2024-05-02T18:52:10+05:30,2024-05-02,S17254528,UPI/412326387284/185209/UPI/gpay-11223375885ok,NA
DEBIT,UPI,400.0,233.21,2024-05-02T19:36:40+05:30,2024-05-02,S20833436,UPI/412343080386/193639/UPI/mohitkingguptaoksb,NA
DEBIT,UPI,130.0,103.21,2024-05-02T20:52:08+05:30,2024-05-02,S26273728,UPI/412369706366/205207/UPI/gpay-11223375885ok,NA
CREDIT,OTHERS,320.0,423.21,2024-05-03T08:07:58+05:30,2024-05-03,S36077720,NEFT-AXNPN12492944519-PHONEPE PRIVATE LIMITED-PAYM,922020004688715
DEBIT,UPI,50.0,373.21,2024-05-03T17:07:53+05:30,2024-05-03,S64012506,UPI/412478851234/170752/UPI/paytmqr1reyim9t8ap,NA
DEBIT,UPI,180.0,193.21,2024-05-03T21:08:57+05:30,2024-05-03,S80649117,UPI/412423146460/210857/UPI/paytmqry2gi373hdmp,NA
CREDIT,OTHERS,1380.0,1573.21,2024-05-04T06:21:33+05:30,2024-05-04,S86992598,NEFT-AXNPN12502718447-PHONEPE PRIVATE LIMITED-PAYM,922020004688715
DEBIT,UPI,20.0,1553.21,2024-05-04T12:52:35+05:30,2024-05-04,S5651160,UPI/412594737468/125235/UPI/gpay-11241743384ok,NA
DEBIT,UPI,130.0,1423.21,2024-05-04T16:59:11+05:30,2024-05-04,S18203242,UPI/412525789277/165911/UPI/gpay-11223375885ok,NA
DEBIT,UPI,400.0,1023.21,2024-05-04T19:42:35+05:30,2024-05-04,S29083516,UPI/412526227849/194235/UPI/mohitkingguptaoksb,NA
CREDIT,OTHERS,800.0,1823.21,2024-05-05T05:32:08+05:30,2024-05-05,S41694222,NEFT-AXNPN12612305141-PHONEPE PRIVATE LIMITED-PAYM,922020004688715
DEBIT,UPI,110.0,1713.21,2024-05-05T10:17:18+05:30,2024-05-05,S50819434,UPI/449253889194/101718/UPI/Q480037413ybl/Paym,NA
DEBIT,UPI,80.0,1633.21,2024-05-05T16:31:42+05:30,2024-05-05,S68814765,UPI/449229901049/163141/UPI/Q904851086ybl/Paym,NA
DEBIT,UPI,130.0,1503.21,2024-05-05T16:44:21+05:30,2024-05-05,S69362575,UPI/412698973627/164421/UPI/gpay-11223375885ok,NA
DEBIT,UPI,110.0,1393.21,2024-05-05T21:15:14+05:30,2024-05-05,S86054025,UPI/412676674292/211513/UPI/gulzarq723okhdfcba,NA
CREDIT,OTHERS,250.0,1643.21,2024-05-06T05:24:30+05:30,2024-05-06,S91547254,NEFT-AXNPN12720906959-PHONEPE PRIVATE LIMITED-PAYM,922020004688715
DEBIT,UPI,20.0,1623.21,2024-05-06T12:38:42+05:30,2024-05-06,S7612231,UPI/412734087637/123841/UPI/paytmqr1p60nszkmvp,NA
DEBIT,UPI,130.0,1493.21,2024-05-06T13:04:36+05:30,2024-05-06,S9276080,UPI/449398545469/130435/UPI/9910619719ibl/Paym,NA
DEBIT,UPI,130.0,1363.21,2024-05-06T17:04:20+05:30,2024-05-06,S21559174,UPI/412779809735/170420/UPI/gpay-11223375885ok,NA
DEBIT,UPI,20.0,1343.21,2024-05-06T21:00:37+05:30,2024-05-06,S37457565,UPI/449336583930/210037/UPI/Q174736272ybl/Paym,NA
DEBIT,UPI,20.0,1323.21,2024-05-06T21:23:58+05:30,2024-05-06,S38837103,UPI/412708420515/212358/UPI/918960343294paytm/,NA
CREDIT,OTHERS,1700.0,3023.21,2024-05-07T05:13:22+05:30,2024-05-07,S45151293,NEFT-AXNPN12830349193-PHONEPE PRIVATE LIMITED-PAYM,922020004688715
DEBIT,UPI,10.0,3013.21,2024-05-07T10:28:25+05:30,2024-05-07,S53673247,UPI/449446861844/102825/UPI/9045781643ybl/Paym,NA
CREDIT,UPI,150.0,3163.21,2024-05-07T13:48:11+05:30,2024-05-07,S64498120,UPI/449476496945/134811/UPI/9910619719ibl/Paym,NA
DEBIT,UPI,310.0,2853.21,2024-05-07T13:52:04+05:30,2024-05-07,S64690725,UPI/412847178346/135203/UPI/paytm-71838008payt,NA
DEBIT,UPI,30.0,2823.21,2024-05-07T13:55:41+05:30,2024-05-07,S64874520,UPI/449447483930/135541/UPI/8957278788axl/Paym,NA
DEBIT,UPI,1500.0,1323.21,2024-05-07T16:53:22+05:30,2024-05-07,S73019910,UPI/449438113382/165322/UPI/8882239781ibl/Paym,NA
DEBIT,UPI,600.0,723.21,2024-05-07T19:22:11+05:30,2024-05-07,S82496338,UPI/412845581448/192210/UPI/6393859545ybl/UPI,NA
DEBIT,UPI,130.0,593.21,2024-05-07T20:52:20+05:30,2024-05-07,S88726397,UPI/412889343720/205220/UPI/gpay-11223375885ok,NA
DEBIT,UPI,130.0,463.21,2024-05-07T20:52:58+05:30,2024-05-07,S88763571,UPI/412854395551/205258/UPI/gpay-11223375885ok,NA
DEBIT,UPI,19.0,444.21,2024-05-07T22:14:52+05:30,2024-05-07,S92625062,UPI/412854417082/221451/UPI/gpayrechargeokpaya,NA
CREDIT,OTHERS,860.0,1304.21,2024-05-08T05:05:05+05:30,2024-05-08,S95771170,NEFT-AXNPN12939183247-PHONEPE PRIVATE LIMITED-PAYM,922020004688715
DEBIT,UPI,10.0,1294.21,2024-05-08T10:50:10+05:30,2024-05-08,S5706982,UPI/412964632007/105009/UPI/anshulkumar46788ok,NA
DEBIT,UPI,80.0,1214.21,2024-05-08T18:10:59+05:30,2024-05-08,S29026326,UPI/412982083695/181059/UPI/paytmqr1reyim9t8ap,NA
DEBIT,UPI,50.0,1164.21,2024-05-08T18:41:54+05:30,2024-05-08,S31066958,UPI/412959123807/184154/UPI/paytmqr1reyim9t8ap,NA
DEBIT,UPI,250.0,914.21,2024-05-08T20:58:06+05:30,2024-05-08,S40011730,UPI/412989876390/205806/UPI/gpay-11223375885ok,NA
CREDIT,UPI,200.0,1114.21,2024-05-08T21:52:26+05:30,2024-05-08,S43153522,UPI/449561148445/215226/UPI/8318914152axl/Paym,NA
DEBIT,UPI,100.0,1014.21,2024-05-09T09:52:32+05:30,2024-05-09,S53963012,UPI/449692534578/095232/UPI/8090506272axl/Paym,NA
DEBIT,UPI,30.0,984.21,2024-05-09T10:08:52+05:30,2024-05-09,S54736275,UPI/449639768355/100851/UPI/Q329690445ybl/Paym,NA
DEBIT,UPI,20.0,964.21,2024-05-09T11:20:18+05:30,2024-05-09,S58723963,UPI/413068391705/112017/UPI/paytmqrsqnezwmgulp,NA
DEBIT,UPI,25.0,939.21,2024-05-09T15:30:59+05:30,2024-05-09,S71709798,UPI/413039783300/153058/UPI/BHARATPE9006808906,NA
DEBIT,UPI,20.0,919.21,2024-05-09T15:38:07+05:30,2024-05-09,S72035289,UPI/449633310431/153806/UPI/Q241715787ybl/Paym,NA
DEBIT,UPI,900.0,19.21,2024-05-09T15:52:11+05:30,2024-05-09,S72702895,UPI/449647206056/155210/UPI/kaleemsiddiqui798y,NA
CREDIT,OTHERS,50.0,69.21,2024-05-09T19:38:29+05:30,2024-05-09,S87404329,IMPS/P2A/413019342635/PHONEPEPRIVATEL/IMPSAXB9111,NA
DEBIT,UPI,19.0,50.21,2024-05-09T21:44:12+05:30,2024-05-09,S95492504,UPI/413036240710/214411/UPI/gpayrechargeokpaya,NA
CREDIT,UPI,4000.0,4050.21,2024-05-10T08:58:30+05:30,2024-05-10,S6663524,UPI/449714971666/085830/UPI/abhishekshakya8172,NA
DEBIT,UPI,20.0,4030.21,2024-05-10T10:25:27+05:30,2024-05-10,S10946820,UPI/413146586526/102527/UPI/bharatpe9006655445,NA
DEBIT,UPI,2000.0,2030.21,2024-05-10T15:13:20+05:30,2024-05-10,S25942694,UPI/449780649234/151319/UPI/8303922846ibl/Paym,NA
DEBIT,UPI,80.0,1950.21,2024-05-10T15:41:45+05:30,2024-05-10,S27180404,UPI/413196184405/154144/UPI/paytmqr1reyim9t8ap,NA
DEBIT,UPI,130.0,1820.21,2024-05-10T17:55:09+05:30,2024-05-10,S34255144,UPI/413115502266/175509/UPI/gpay-11223375885ok,NA
CREDIT,OTHERS,570.0,2390.21,2024-05-11T05:15:27+05:30,2024-05-11,S53647046,NEFT-AXNPN13269302343-PHONEPE PRIVATE LIMITED-PAYM,922020004688715
DEBIT,UPI,10.0,2380.21,2024-05-11T12:20:17+05:30,2024-05-11,S67006600,UPI/449834826630/122017/UPI/Q290444500ybl/Paym,NA
DEBIT,UPI,130.0,2250.21,2024-05-11T17:36:38+05:30,2024-05-11,S82858678,UPI/413229660750/173638/UPI/gpay-11223375885ok,NA
DEBIT,UPI,80.0,2170.21,2024-05-11T18:06:10+05:30,2024-05-11,S84640091,UPI/413209948773/180610/UPI/paytmqr1reyim9t8ap,NA
DEBIT,UPI,1000.0,1170.21,2024-05-11T19:43:21+05:30,2024-05-11,S91329786,UPI/449874659890/194320/UPI/deepali6790ibl/Pay,NA
DEBIT,UPI,240.9,929.31,2024-05-11T20:06:44+05:30,2024-05-11,S92918586,UPI/413213167623/200643/UPI/gpayrechargeokpaya,NA
CREDIT,OTHERS,1750.0,2679.31,2024-05-12T05:23:38+05:30,2024-05-12,S2269895,NEFT-AXNPN13378172709-PHONEPE PRIVATE LIMITED-PAYM,922020004688715
DEBIT,UPI,10.0,2669.31,2024-05-12T16:49:20+05:30,2024-05-12,S27011398,UPI/449931860287/164919/UPI/Q087828198ybl/Paym,NA
DEBIT,UPI,70.0,2599.31,2024-05-12T18:33:02+05:30,2024-05-12,S32371814,UPI/413315037068/183301/UPI/amitkumar081270-1o,NA
DEBIT,UPI,200.0,2399.31,2024-05-12T19:34:31+05:30,2024-05-12,S36767697,UPI/413351516297/193430/UPI/6393859545ybl/UPI,NA
DEBIT,UPI,205.0,2194.31,2024-05-12T21:52:50+05:30,2024-05-12,S44412098,UPI/413387106387/215250/UPI/BHARATPE9006965490,NA
DEBIT,UPI,20.0,2174.31,2024-05-13T03:37:08+05:30,2024-05-13,C85130944,UPI/450034162751/005948/UPI/Q040012184ybl/Paym,NA
CREDIT,OTHERS,11530.0,13704.31,2024-05-13T06:54:41+05:30,2024-05-13,S48586185,NEFT-AXNPN13487029272-PHONEPE PRIVATE LIMITED-PAYM,922020004688715
DEBIT,UPI,40.0,13664.31,2024-05-13T14:31:52+05:30,2024-05-13,S68002681,UPI/450031272882/143151/UPI/7895745727-2ibl/Pa,NA
DEBIT,UPI,30.0,13634.31,2024-05-13T17:06:18+05:30,2024-05-13,S75053646,UPI/450013966680/170618/UPI/Q780083197ybl/Paym,NA
DEBIT,UPI,40.0,13594.31,2024-05-13T18:44:16+05:30,2024-05-13,S80912068,UPI/450080770817/184415/UPI/9548226795axl/Paym,NA
DEBIT,UPI,10.0,13584.31,2024-05-14T11:04:57+05:30,2024-05-14,S8153568,UPI/413517301479/110456/UPI/BHARATPE9006574786,NA
DEBIT,UPI,10000.0,3584.31,2024-05-14T11:51:56+05:30,2024-05-14,S10609765,UPI/413509744677/115155/UPI/9910619719ybl/UPI,NA
DEBIT,UPI,40.0,3544.31,2024-05-14T15:38:27+05:30,2024-05-14,S21917028,UPI/413526231921/153826/UPI/BHARATPE9006729889,NA
DEBIT,UPI,600.0,2944.31,2024-05-14T19:24:52+05:30,2024-05-14,S35248853,UPI/413528369850/192452/UPI/6393859545ybl/UPI,NA
DEBIT,UPI,500.0,2444.31,2024-05-14T21:13:55+05:30,2024-05-14,S42673661,UPI/413510430627/211354/UPI/BHARATPE9006655445,NA
DEBIT,UPI,150.0,2294.31,2024-05-14T21:29:18+05:30,2024-05-14,S43468709,UPI/413533332615/212918/UPI/paytm-71838008payt,NA
CREDIT,OTHERS,650.0,2944.31,2024-05-15T05:55:03+05:30,2024-05-15,S48806823,NEFT-AXNPN13606008279-PHONEPE PRIVATE LIMITED-PAYM,922020004688715
DEBIT,UPI,15.0,2929.31,2024-05-15T08:04:36+05:30,2024-05-15,S50958972,UPI/450258346200/080436/UPI/JIOINAPPDIRECTaxl/,NA
DEBIT,UPI,130.0,2799.31,2024-05-15T13:14:03+05:30,2024-05-15,S66534168,UPI/413637754025/131403/UPI/gpay-11223375885ok,NA
DEBIT,UPI,100.0,2699.31,2024-05-15T14:52:12+05:30,2024-05-15,S71347352,UPI/450260923857/145212/UPI/9555633248ybl/Paym,NA
DEBIT,UPI,500.0,2199.31,2024-05-15T17:17:13+05:30,2024-05-15,S78208027,UPI/450246816891/171713/UPI/6386098404axl/Paym,NA
DEBIT,UPI,15.0,2184.31,2024-05-15T22:15:36+05:30,2024-05-15,S96997684,UPI/450281155814/221536/UPI/JIOINAPPDIRECT1axl,NA
DEBIT,UPI,10.0,2174.31,2024-05-15T22:36:57+05:30,2024-05-15,S97669790,UPI/450273719291/223657/UPI/7860606760ibl/Paym,NA
CREDIT,OTHERS,130.0,2304.31,2024-05-16T05:10:20+05:30,2024-05-16,S228104,NEFT-AXNPN13715616213-PHONEPE PRIVATE LIMITED-PAYM,922020004688715
DEBIT,UPI,30.0,2274.31,2024-05-16T17:16:11+05:30,2024-05-16,S28006608,UPI/413780937691/171611/UPI/gpay-11223375885ok,NA
DEBIT,UPI,130.0,2144.31,2024-05-16T18:00:23+05:30,2024-05-16,S30427191,UPI/413789877383/180022/UPI/gpay-11223375885ok,NA
DEBIT,UPI,400.0,1744.31,2024-05-16T19:26:35+05:30,2024-05-16,S36373946,UPI/413707095122/192635/UPI/6393859545ybl/UPI,NA
CREDIT,UPI,1000.0,2744.31,2024-05-16T19:58:36+05:30,2024-05-16,S38647092,UPI/413743064071/195836/UPI/8115504793nehajiyb,NA
DEBIT,UPI,130.0,2614.31,2024-05-16T20:46:55+05:30,2024-05-16,S41770836,UPI/413781345143/204654/UPI/gpay-11223375885ok,NA
DEBIT,UPI,500.0,2114.31,2024-05-16T20:48:53+05:30,2024-05-16,S41891196,UPI/450397231212/204852/UPI/9936263584ybl/Paym,NA
CREDIT,OTHERS,650.0,2764.31,2024-05-17T04:44:25+05:30,2024-05-17,S48693067,NEFT-AXNPN13824410081-PHONEPE PRIVATE LIMITED-PAYM,922020004688715
DEBIT,UPI,110.0,2654.31,2024-05-17T09:54:31+05:30,2024-05-17,S55119388,UPI/450441738311/095430/UPI/Q936188905ybl/Paym,NA
DEBIT,UPI,95.0,2559.31,2024-05-17T14:53:22+05:30,2024-05-17,S69792660,UPI/450420574126/145322/UPI/Q889878872ybl/Paym,NA
DEBIT,UPI,1300.0,1259.31,2024-05-17T18:51:36+05:30,2024-05-17,S82091692,UPI/413826854467/185136/UPI/faizanrangrezz44-1,NA
DEBIT,UPI,260.0,999.31,2024-05-18T13:36:24+05:30,2024-05-18,S14717211,UPI/413905927079/133624/UPI/gpay-11223375885ok,NA
DEBIT,UPI,15.0,984.31,2024-05-18T17:03:14+05:30,2024-05-18,S24414209,UPI/450511341512/170313/UPI/JIOINAPPDIRECT1ybl,NA
DEBIT,UPI,50.0,934.31,2024-05-18T19:44:07+05:30,2024-05-18,S34122074,UPI/413966040271/194406/UPI/paytmqr1reyim9t8ap,NA
DEBIT,UPI,50.0,884.31,2024-05-18T20:53:26+05:30,2024-05-18,S38728944,UPI/413999509193/205325/UPI/UPILITE/LOAD/LITE,NA
DEBIT,UPI,60.0,824.31,2024-05-19T10:24:48+05:30,2024-05-19,S54307558,UPI/450629640910/102447/UPI/Q936188905ybl/Paym,NA
CREDIT,UPI,100.0,924.31,2024-05-19T12:15:40+05:30,2024-05-19,S59715258,UPI/450601898350/121541/UPI/8303922846ibl/Paym,NA
DEBIT,UPI,20.0,904.31,2024-05-19T12:26:51+05:30,2024-05-19,S60227792,UPI/414092229094/122650/UPI/paytmqrdrfplk18zap,NA
DEBIT,UPI,130.0,774.31,2024-05-19T17:01:14+05:30,2024-05-19,S71560094,UPI/414030615217/170113/UPI/gpay-11223375885ok,NA
DEBIT,UPI,50.0,724.31,2024-05-19T17:44:31+05:30,2024-05-19,S73615728,UPI/414040673279/174431/UPI/paytmqr1reyim9t8ap,NA
DEBIT,UPI,400.0,324.31,2024-05-19T19:40:29+05:30,2024-05-19,S80998230,UPI/414025794085/194028/UPI/mohitkingguptaoksb,NA
DEBIT,UPI,15.0,309.31,2024-05-19T20:32:25+05:30,2024-05-19,S84350980,UPI/450654811823/203224/UPI/JIOINAPPDIRECTaxl/,NA
DEBIT,UPI,130.0,179.31,2024-05-20T13:27:57+05:30,2024-05-20,S8218942,UPI/414115316842/132757/UPI/gpay-11223375885ok,NA
DEBIT,UPI,130.0,49.31,2024-05-20T17:26:51+05:30,2024-05-20,S19005868,UPI/414156213747/172651/UPI/gpay-11223375885ok,NA
CREDIT,OTHERS,1070.0,1119.31,2024-05-21T05:47:33+05:30,2024-05-21,S39063328,NEFT-AXNPN14261608351-PHONEPE PRIVATE LIMITED-PAYM,922020004688715
DEBIT,UPI,55.0,1064.31,2024-05-21T09:47:32+05:30,2024-05-21,S45076297,UPI/450831801738/094731/UPI/Q936188905ybl/Paym,NA
DEBIT,UPI,130.0,934.31,2024-05-21T14:29:35+05:30,2024-05-21,S59238697,UPI/414280984745/142935/UPI/gpay-11223375885ok,NA
DEBIT,UPI,400.0,534.31,2024-05-21T19:23:37+05:30,2024-05-21,S74735090,UPI/414200512088/192336/UPI/mohitkingguptaokic,NA
DEBIT,UPI,130.0,404.31,2024-05-21T21:23:33+05:30,2024-05-21,S82499753,UPI/414222731487/212333/UPI/gpay-11223375885ok,NA
CREDIT,OTHERS,2050.0,2454.31,2024-05-22T04:42:07+05:30,2024-05-22,S87744917,NEFT-AXNPN14371290011-PHONEPE PRIVATE LIMITED-PAYM,922020004688715
DEBIT,UPI,19.0,2435.31,2024-05-22T14:10:51+05:30,2024-05-22,S7150388,UPI/450957409812/141051/UPI/JIOINAPPDIRECTaxl/,NA
DEBIT,UPI,240.0,2195.31,2024-05-22T14:48:58+05:30,2024-05-22,S8931946,UPI/414310082234/144858/UPI/gpay-11223375885ok,NA
DEBIT,UPI,20.0,2175.31,2024-05-22T14:49:42+05:30,2024-05-22,S8969652,UPI/414328946157/144941/UPI/gpay-11223375885ok,NA
DEBIT,UPI,10.0,2165.31,2024-05-22T18:04:30+05:30,2024-05-22,S17888462,UPI/450960299185/180430/UPI/Q290444500ybl/Paym,NA
CREDIT,UPI,3920.0,6085.31,2024-05-22T20:21:48+05:30,2024-05-22,S26902030,UPI/450963336655/202149/UPI/sajalgupta123ybl/P,NA
DEBIT,UPI,3920.0,2165.31,2024-05-22T20:25:35+05:30,2024-05-22,S27164821,UPI/450900888765/202535/UPI/sajalgupta123ibl/P,NA
DEBIT,UPI,130.0,2035.31,2024-05-22T21:02:23+05:30,2024-05-22,S29541198,UPI/414365291382/210222/UPI/gpay-11223375885ok,NA
CREDIT,OTHERS,650.0,2685.31,2024-05-23T05:26:11+05:30,2024-05-23,S35532875,NEFT-AXNPN14480896873-PHONEPE PRIVATE LIMITED-PAYM,922020004688715
DEBIT,UPI,260.0,2425.31,2024-05-23T11:18:03+05:30,2024-05-23,S45633941,UPI/414411227482/111803/UPI/gpay-11223375885ok,NA
DEBIT,UPI,260.0,2165.31,2024-05-23T12:09:28+05:30,2024-05-23,S48150388,UPI/414402380220/120928/UPI/gpay-11223375885ok,NA
DEBIT,UPI,15.0,2150.31,2024-05-23T15:23:42+05:30,2024-05-23,S57030991,UPI/414485148171/152341/UPI/paytmqr1se00pfsn5p,NA
DEBIT,UPI,260.0,1890.31,2024-05-23T16:59:54+05:30,2024-05-23,S60874237,UPI/414408262921/165953/UPI/gpay-11223375885ok,NA
DEBIT,UPI,20.0,1870.31,2024-05-23T18:13:02+05:30,2024-05-23,S64517156,UPI/451029592538/181302/UPI/Q000560684ybl/Paym,NA
DEBIT,UPI,260.0,1610.31,2024-05-23T19:35:36+05:30,2024-05-23,S69743726,UPI/414468554047/193536/UPI/gpay-11223375885ok,NA
DEBIT,UPI,260.0,1350.31,2024-05-23T21:34:36+05:30,2024-05-23,S76928730,UPI/414483814671/213436/UPI/q840072483ybl/UPI,NA
DEBIT,UPI,130.0,1220.31,2024-05-24T13:44:42+05:30,2024-05-24,S3094300,UPI/414594884478/134441/UPI/gpay-11223375885ok,NA
DEBIT,UPI,600.0,620.31,2024-05-24T19:33:45+05:30,2024-05-24,S24475102,UPI/414515790893/193345/UPI/mohitkingguptaokhd,NA
CREDIT,UPI,600.0,1220.31,2024-05-24T19:33:51+05:30,2024-05-24,S24480611,UPI/414515790893/193350/REVERSAL,NA
DEBIT,UPI,130.0,1090.31,2024-05-24T19:42:08+05:30,2024-05-24,S25092313,UPI/414564456590/194207/UPI/gpay-11223375885ok,NA
CREDIT,OTHERS,600.0,1690.31,2024-05-25T07:47:07+05:30,2024-05-25,S39142940,NEFT-AXNPN14699634650-PHONEPE PRIVATE LIMITED-PAYM,922020004688715
DEBIT,UPI,50.0,1640.31,2024-05-25T09:49:10+05:30,2024-05-25,S43699064,UPI/414621268409/094909/UPI/BHARATPE9006892179,NA
DEBIT,UPI,60.0,1580.31,2024-05-25T10:36:53+05:30,2024-05-25,S45900367,UPI/451238368076/103653/UPI/Q936188905ybl/Paym,NA
DEBIT,UPI,10.0,1570.31,2024-05-25T10:54:46+05:30,2024-05-25,S46817724,UPI/451291691972/105446/UPI/Q514575473ybl/Paym,NA
DEBIT,UPI,640.0,930.31,2024-05-25T14:11:41+05:30,2024-05-25,S58284661,UPI/451207360360/141141/UPI/Q420727784ybl/Paym,NA
DEBIT,UPI,130.0,800.31,2024-05-25T16:59:06+05:30,2024-05-25,S65793336,UPI/414609766507/165905/UPI/gpay-11223375885ok,NA
DEBIT,UPI,10.0,790.31,2024-05-25T17:01:24+05:30,2024-05-25,S65911676,UPI/451290746500/170123/UPI/Q290444500ybl/Paym,NA
DEBIT,UPI,80.0,710.31,2024-05-25T18:10:37+05:30,2024-05-25,S70189396,UPI/414600010566/181036/UPI/paytmqr1reyim9t8ap,NA
DEBIT,UPI,20.0,690.31,2024-05-25T21:41:13+05:30,2024-05-25,S83193568,UPI/414672041810/214113/UPI/paytmqr1se00pfsn5p,NA
CREDIT,OTHERS,1000.0,1690.31,2024-05-25T22:54:11+05:30,2024-05-25,S85499451,IMPS/P2A/414622757146/ONE97COMMUNICAT/IMPSAXB9199,NA
DEBIT,UPI,20.0,1670.31,2024-05-26T07:44:13+05:30,2024-05-26,S89057030,UPI/414707490257/074413/UPI/paytmqr16gldnpaytm,NA
DEBIT,UPI,30.0,1640.31,2024-05-26T08:21:03+05:30,2024-05-26,S89921489,UPI/414783492167/082102/UPI/paytm-79496683payt,NA
DEBIT,UPI,30.0,1610.31,2024-05-26T09:12:54+05:30,2024-05-26,S91523582,UPI/414754820953/091254/UPI/paytmqr556sdtpaytm,NA
DEBIT,UPI,30.0,1580.31,2024-05-26T11:02:43+05:30,2024-05-26,S96022532,UPI/414726944209/110243/UPI/paytmqr553klypaytm,NA
DEBIT,UPI,400.0,1180.31,2024-05-26T16:29:27+05:30,2024-05-26,S9294814,UPI/451380259328/162927/UPI/987132751101ibl/Pa,NA
DEBIT,UPI,10.0,1170.31,2024-05-26T18:46:48+05:30,2024-05-26,S17969280,UPI/414773072076/184647/UPI/paytmqr109nc9ruhup,NA
DEBIT,UPI,216.0,954.31,2024-05-27T03:39:25+05:30,2024-05-26,C98744362,UPI/414700647236/233652/UPI/paytmqr281005050101,NA
DEBIT,UPI,260.0,694.31,2024-05-27T12:17:55+05:30,2024-05-27,S45954314,UPI/414822688109/121755/UPI/gpay-11223375885ok,NA
DEBIT,UPI,50.0,644.31,2024-05-27T16:20:10+05:30,2024-05-27,S59610523,UPI/414809057729/162010/UPI/paytmqr1reyim9t8ap,NA
DEBIT,UPI,20.0,624.31,2024-05-27T17:26:56+05:30,2024-05-27,S63058979,UPI/414852294503/172655/UPI/paytmqr281005050101,NA
DEBIT,UPI,130.0,494.31,2024-05-27T18:25:59+05:30,2024-05-27,S66582457,UPI/414852275431/182559/UPI/gpay-11223375885ok,NA
DEBIT,UPI,175.0,319.31,2024-05-27T19:53:23+05:30,2024-05-27,S72840952,UPI/451446471636/195322/UPI/Q935592796ybl/Paym,NA
CREDIT,OTHERS,210.0,529.31,2024-05-28T05:41:08+05:30,2024-05-28,S84053875,NEFT-AXNPN14927376982-PHONEPE PRIVATE LIMITED-PAYM,922020004688715
DEBIT,UPI,130.0,399.31,2024-05-28T12:09:13+05:30,2024-05-28,S3529558,UPI/414983060461/120913/UPI/gpay-11223375885ok,NA
DEBIT,UPI,130.0,269.31,2024-05-28T20:45:38+05:30,2024-05-28,S31744671,UPI/414942119710/204537/UPI/gpay-11223375885ok,NA
CREDIT,OTHERS,150.0,419.31,2024-05-29T06:03:44+05:30,2024-05-29,S38920101,NEFT-AXNPN15036609374-PHONEPE PRIVATE LIMITED-PAYM,922020004688715
DEBIT,UPI,240.9,178.41,2024-05-29T08:53:10+05:30,2024-05-29,S43796126,UPI/415078559131/085310/UPI/gpayrechargeicici/,NA
DEBIT,UPI,130.0,48.41,2024-05-29T12:01:51+05:30,2024-05-29,S53022278,UPI/415085026291/120151/UPI/gpay-11223375885ok,NA
CREDIT,UPI,300.0,348.41,2024-05-29T17:10:42+05:30,2024-05-29,S66468359,UPI/415061496542/171043/UPI/7786043828ibl/Paym,NA
DEBIT,UPI,245.0,103.41,2024-05-29T17:12:19+05:30,2024-05-29,S66551053,UPI/451629965942/171219/UPI/9910619719ibl/Paym,NA
DEBIT,UPI,80.0,23.41,2024-05-29T17:57:40+05:30,2024-05-29,S68913329,UPI/415067358040/175740/UPI/paytmqr1reyim9t8ap,NA
CREDIT,OTHERS,938.0,961.41,2024-05-30T05:07:05+05:30,2024-05-30,S87517914,NEFT-AXNPN15145877034-PHONEPE PRIVATE LIMITED-PAYM,922020004688715
DEBIT,UPI,60.0,901.41,2024-05-30T09:58:24+05:30,2024-05-30,S94085910,UPI/451708846336/095823/UPI/Q936188905ybl/Paym,NA
DEBIT,UPI,130.0,771.41,2024-05-30T13:30:30+05:30,2024-05-30,S4676116,UPI/451747322898/133029/UPI/Q601737327ybl/Paym,NA
DEBIT,UPI,10.0,761.41,2024-05-30T13:38:20+05:30,2024-05-30,S5042978,UPI/451711506710/133820/UPI/Q596679282ybl/Paym,NA
